,,,,,Angle,,,,Intensity
10,2184,1,,,10,632,1,,1552
10.02,2274,1,,,10.02,586,1,,1688
10.04,2308,1,,,10.04,631,1,,1677
10.06,2276,1,,,10.06,645,1,,1631
10.08,2281,1,,,10.08,631,1,,1650
10.1,2346,1,,,10.1,610,1,,1736
10.12,2293,1,,,10.12,642,1,,1651
10.14,2252,1,,,10.14,643,1,,1609
10.16,2244,1,,,10.16,609,1,,1635
10.18,2294,1,,,10.18,602,1,,1692
10.2,2264,1,,,10.2,655,1,,1609
10.22,2306,1,,,10.22,642,1,,1664
10.24,2285,1,,,10.24,641,1,,1644
10.26,2221,1,,,10.26,612,1,,1609
10.28,2150,1,,,10.28,670,1,,1480
10.3,2234,1,,,10.3,579,1,,1655
10.32,2161,1,,,10.32,655,1,,1506
10.34,2206,1,,,10.34,622,1,,1584
10.36,2233,1,,,10.36,611,1,,1622
10.38,2156,1,,,10.38,630,1,,1526
10.4,2208,1,,,10.4,611,1,,1597
10.42,2211,1,,,10.42,595,1,,1616
10.44,2177,1,,,10.44,614,1,,1563
10.46,2294,1,,,10.46,625,1,,1669
10.48,2228,1,,,10.48,622,1,,1606
10.5,2174,1,,,10.5,617,1,,1557
10.52,2229,1,,,10.52,630,1,,1599
10.54,2192,1,,,10.54,654,1,,1538
10.56,2199,1,,,10.56,639,1,,1560
10.58,2136,1,,,10.58,663,1,,1473
10.6,2182,1,,,10.6,632,1,,1550
10.62,2184,1,,,10.62,638,1,,1546
10.64,2168,1,,,10.64,661,1,,1507
10.66,2210,1,,,10.66,621,1,,1589
10.68,2277,1,,,10.68,625,1,,1652
10.7,2194,1,,,10.7,653,1,,1541
10.72,2198,1,,,10.72,666,1,,1532
10.74,2203,1,,,10.74,620,1,,1583
10.76,2305,1,,,10.76,658,1,,1647
10.78,2316,1,,,10.78,642,1,,1674
10.8,2332,1,,,10.8,684,1,,1648
10.82,2283,1,,,10.82,673,1,,1610
10.84,2332,1,,,10.84,623,1,,1709
10.86,2332,1,,,10.86,656,1,,1676
10.88,2510,1,,,10.88,680,1,,1830
10.9,2441,1,,,10.9,681,1,,1760
10.92,2431,1,,,10.92,627,1,,1804
10.94,2452,1,,,10.94,669,1,,1783
10.96,2515,1,,,10.96,642,1,,1873
10.98,2690,1,,,10.98,690,1,,2000
11,2763,1,,,11,627,1,,2136
11.02,2880,1,,,11.02,703,1,,2177
11.04,2927,1,,,11.04,707,1,,2220
11.06,2983,1,,,11.06,656,1,,2327
11.08,3233,1,,,11.08,662,1,,2571
11.1,3248,1,,,11.1,687,1,,2561
11.12,3225,1,,,11.12,676,1,,2549
11.14,3387,1,,,11.14,665,1,,2722
11.16,3474,1,,,11.16,661,1,,2813
11.18,3600,1,,,11.18,647,1,,2953
11.2,3889,1,,,11.2,653,1,,3236
11.22,4158,1,,,11.22,648,1,,3510
11.24,4369,1,,,11.24,681,1,,3688
11.26,4614,1,,,11.26,715,1,,3899
11.28,5060,1,,,11.28,679,1,,4381
11.3,5459,1,,,11.3,691,1,,4768
11.32,5872,1,,,11.32,692,1,,5180
11.34,6502,1,,,11.34,663,1,,5839
11.36,7093,1,,,11.36,689,1,,6404
11.38,7791,1,,,11.38,679,1,,7112
11.4,8556,1,,,11.4,660,1,,7896
11.42,9647,1,,,11.42,686,1,,8961
11.44,10947,1,,,11.44,713,1,,10234
11.46,12254,1,,,11.46,629,1,,11625
11.48,14034,1,,,11.48,712,1,,13322
11.5,15944,1,,,11.5,668,1,,15276
11.52,17889,1,,,11.52,674,1,,17215
11.54,19966,1,,,11.54,676,1,,19290
11.56,21940,1,,,11.56,679,1,,21261
11.58,24304,1,,,11.58,673,1,,23631
11.6,26198,1,,,11.6,671,1,,25527
11.62,27852,1,,,11.62,692,1,,27160
11.64,29152,1,,,11.64,670,1,,28482
11.66,29287,1,,,11.66,690,1,,28597
11.68,29583,1,,,11.68,713,1,,28870
11.7,29470,1,,,11.7,695,1,,28775
11.72,28282,1,,,11.72,710,1,,27572
11.74,26740,1,,,11.74,679,1,,26061
11.76,24521,1,,,11.76,695,1,,23826
11.78,21180,1,,,11.78,698,1,,20482
11.8,18087,1,,,11.8,715,1,,17372
11.82,15175,1,,,11.82,728,1,,14447
11.84,12602,1,,,11.84,752,1,,11850
11.86,10390,1,,,11.86,679,1,,9711
11.88,8562,1,,,11.88,708,1,,7854
11.9,7218,1,,,11.9,668,1,,6550
11.92,6033,1,,,11.92,690,1,,5343
11.94,5358,1,,,11.94,736,1,,4622
11.96,4731,1,,,11.96,673,1,,4058
11.98,4395,1,,,11.98,764,1,,3631
12,4012,1,,,12,679,1,,3333
12.02,3790,1,,,12.02,719,1,,3071
12.04,3597,1,,,12.04,776,1,,2821
12.06,3521,1,,,12.06,719,1,,2802
12.08,3244,1,,,12.08,716,1,,2528
12.1,3179,1,,,12.1,755,1,,2424
12.12,3086,1,,,12.12,786,1,,2300
12.14,3060,1,,,12.14,749,1,,2311
12.16,2951,1,,,12.16,760,1,,2191
12.18,2926,1,,,12.18,766,1,,2160
12.2,2937,1,,,12.2,727,1,,2210
12.22,2863,1,,,12.22,714,1,,2149
12.24,2799,1,,,12.24,745,1,,2054
12.26,2762,1,,,12.26,723,1,,2039
12.28,2753,1,,,12.28,721,1,,2032
12.3,2739,1,,,12.3,728,1,,2011
12.32,2666,1,,,12.32,779,1,,1887
12.34,2676,1,,,12.34,752,1,,1924
12.36,2579,1,,,12.36,758,1,,1821
12.38,2644,1,,,12.38,760,1,,1884
12.4,2687,1,,,12.4,735,1,,1952
12.42,2618,1,,,12.42,757,1,,1861
12.44,2569,1,,,12.44,780,1,,1789
12.46,2485,1,,,12.46,752,1,,1733
12.48,2491,1,,,12.48,766,1,,1725
12.5,2485,1,,,12.5,784,1,,1701
12.52,2499,1,,,12.52,745,1,,1754
12.54,2552,1,,,12.54,783,1,,1769
12.56,2451,1,,,12.56,777,1,,1674
12.58,2545,1,,,12.58,708,1,,1837
12.6,2505,1,,,12.6,729,1,,1776
12.62,2470,1,,,12.62,771,1,,1699
12.64,2453,1,,,12.64,766,1,,1687
12.66,2456,1,,,12.66,806,1,,1650
12.68,2476,1,,,12.68,781,1,,1695
12.7,2458,1,,,12.7,753,1,,1705
12.72,2454,1,,,12.72,746,1,,1708
12.74,2414,1,,,12.74,736,1,,1678
12.76,2387,1,,,12.76,725,1,,1662
12.78,2370,1,,,12.78,746,1,,1624
12.8,2411,1,,,12.8,745,1,,1666
12.82,2442,1,,,12.82,788,1,,1654
12.84,2441,1,,,12.84,801,1,,1640
12.86,2407,1,,,12.86,766,1,,1641
12.88,2371,1,,,12.88,795,1,,1576
12.9,2340,1,,,12.9,772,1,,1568
12.92,2394,1,,,12.92,785,1,,1609
12.94,2456,1,,,12.94,824,1,,1632
12.96,2368,1,,,12.96,767,1,,1601
12.98,2357,1,,,12.98,751,1,,1606
13,2476,1,,,13,760,1,,1716
13.02,2453,1,,,13.02,770,1,,1683
13.04,2421,1,,,13.04,762,1,,1659
13.06,2461,1,,,13.06,811,1,,1650
13.08,2419,1,,,13.08,807,1,,1612
13.1,2435,1,,,13.1,798,1,,1637
13.12,2392,1,,,13.12,804,1,,1588
13.14,2383,1,,,13.14,775,1,,1608
13.16,2391,1,,,13.16,771,1,,1620
13.18,2365,1,,,13.18,757,1,,1608
13.2,2451,1,,,13.2,816,1,,1635
13.22,2553,1,,,13.22,775,1,,1778
13.24,2476,1,,,13.24,813,1,,1663
13.26,2485,1,,,13.26,811,1,,1674
13.28,2552,1,,,13.28,833,1,,1719
13.3,2589,1,,,13.3,823,1,,1766
13.32,2536,1,,,13.32,845,1,,1691
13.34,2602,1,,,13.34,861,1,,1741
13.36,2547,1,,,13.36,816,1,,1731
13.38,2517,1,,,13.38,812,1,,1705
13.4,2497,1,,,13.4,836,1,,1661
13.42,2512,1,,,13.42,833,1,,1679
13.44,2471,1,,,13.44,811,1,,1660
13.46,2445,1,,,13.46,825,1,,1620
13.48,2525,1,,,13.48,814,1,,1711
13.5,2454,1,,,13.5,859,1,,1595
13.52,2526,1,,,13.52,866,1,,1660
13.54,2461,1,,,13.54,842,1,,1619
13.56,2461,1,,,13.56,833,1,,1628
13.58,2554,1,,,13.58,831,1,,1723
13.6,2499,1,,,13.6,841,1,,1658
13.62,2494,1,,,13.62,839,1,,1655
13.64,2539,1,,,13.64,849,1,,1690
13.66,2522,1,,,13.66,767,1,,1755
13.68,2514,1,,,13.68,857,1,,1657
13.7,2530,1,,,13.7,839,1,,1691
13.72,2609,1,,,13.72,869,1,,1740
13.74,2547,1,,,13.74,816,1,,1731
13.76,2681,1,,,13.76,849,1,,1832
13.78,2651,1,,,13.78,857,1,,1794
13.8,2675,1,,,13.8,817,1,,1858
13.82,2584,1,,,13.82,878,1,,1706
13.84,2630,1,,,13.84,843,1,,1787
13.86,2707,1,,,13.86,847,1,,1860
13.88,2765,1,,,13.88,865,1,,1900
13.9,2783,1,,,13.9,857,1,,1926
13.92,2832,1,,,13.92,887,1,,1945
13.94,2784,1,,,13.94,837,1,,1947
13.96,2935,1,,,13.96,871,1,,2064
13.98,3019,1,,,13.98,870,1,,2149
14,2979,1,,,14,856,1,,2123
14.02,3133,1,,,14.02,811,1,,2322
14.04,3233,1,,,14.04,836,1,,2397
14.06,3341,1,,,14.06,871,1,,2470
14.08,3508,1,,,14.08,869,1,,2639
14.1,3603,1,,,14.1,913,1,,2690
14.12,3823,1,,,14.12,863,1,,2960
14.14,3984,1,,,14.14,875,1,,3109
14.16,4217,1,,,14.16,885,1,,3332
14.18,4373,1,,,14.18,885,1,,3488
14.2,4790,1,,,14.2,870,1,,3920
14.22,5153,1,,,14.22,915,1,,4238
14.24,5502,1,,,14.24,874,1,,4628
14.26,6013,1,,,14.26,939,1,,5074
14.28,6531,1,,,14.28,928,1,,5603
14.3,7119,1,,,14.3,884,1,,6235
14.32,7817,1,,,14.32,898,1,,6919
14.34,8952,1,,,14.34,891,1,,8061
14.36,9844,1,,,14.36,900,1,,8944
14.38,11123,1,,,14.38,877,1,,10246
14.4,12650,1,,,14.4,895,1,,11755
14.42,14344,1,,,14.42,889,1,,13455
14.44,16025,1,,,14.44,933,1,,15092
14.46,17794,1,,,14.46,983,1,,16811
14.48,19865,1,,,14.48,921,1,,18944
14.5,21735,1,,,14.5,936,1,,20799
14.52,23544,1,,,14.52,900,1,,22644
14.54,24806,1,,,14.54,905,1,,23901
14.56,26274,1,,,14.56,920,1,,25354
14.58,27163,1,,,14.58,886,1,,26277
14.6,27565,1,,,14.6,966,1,,26599
14.62,27955,1,,,14.62,933,1,,27022
14.64,28205,1,,,14.64,959,1,,27246
14.66,28069,1,,,14.66,945,1,,27124
14.68,27689,1,,,14.68,960,1,,26729
14.7,26775,1,,,14.7,923,1,,25852
14.72,25142,1,,,14.72,929,1,,24213
14.74,22548,1,,,14.74,985,1,,21563
14.76,19811,1,,,14.76,936,1,,18875
14.78,17136,1,,,14.78,984,1,,16152
14.8,14291,1,,,14.8,1002,1,,13289
14.82,11916,1,,,14.82,985,1,,10931
14.84,9728,1,,,14.84,943,1,,8785
14.86,8323,1,,,14.86,997,1,,7326
14.88,7226,1,,,14.88,1000,1,,6226
14.9,6299,1,,,14.9,948,1,,5351
14.92,5531,1,,,14.92,972,1,,4559
14.94,5036,1,,,14.94,973,1,,4063
14.96,4694,1,,,14.96,948,1,,3746
14.98,4363,1,,,14.98,965,1,,3398
15,4270,1,,,15,986,1,,3284
15.02,3996,1,,,15.02,1001,1,,2995
15.04,3873,1,,,15.04,985,1,,2888
15.06,3788,1,,,15.06,1001,1,,2787
15.08,3673,1,,,15.08,955,1,,2718
15.1,3520,1,,,15.1,1008,1,,2512
15.12,3558,1,,,15.12,1019,1,,2539
15.14,3476,1,,,15.14,1038,1,,2438
15.16,3369,1,,,15.16,1073,1,,2296
15.18,3251,1,,,15.18,1039,1,,2212
15.2,3209,1,,,15.2,1037,1,,2172
15.22,3305,1,,,15.22,998,1,,2307
15.24,3165,1,,,15.24,1003,1,,2162
15.26,3282,1,,,15.26,1007,1,,2275
15.28,3229,1,,,15.28,1043,1,,2186
15.3,3040,1,,,15.3,1026,1,,2014
15.32,3148,1,,,15.32,1004,1,,2144
15.34,3210,1,,,15.34,1065,1,,2145
15.36,3169,1,,,15.36,994,1,,2175
15.38,3112,1,,,15.38,1013,1,,2099
15.4,3057,1,,,15.4,1014,1,,2043
15.42,2998,1,,,15.42,1054,1,,1944
15.44,3110,1,,,15.44,1036,1,,2074
15.46,3172,1,,,15.46,1068,1,,2104
15.48,3185,1,,,15.48,995,1,,2190
15.5,3220,1,,,15.5,1044,1,,2176
15.52,3125,1,,,15.52,1019,1,,2106
15.54,3145,1,,,15.54,1008,1,,2137
15.56,3200,1,,,15.56,1045,1,,2155
15.58,3163,1,,,15.58,1056,1,,2107
15.6,3111,1,,,15.6,1040,1,,2071
15.62,3183,1,,,15.62,1087,1,,2096
15.64,3133,1,,,15.64,1071,1,,2062
15.66,3094,1,,,15.66,1050,1,,2044
15.68,2973,1,,,15.68,975,1,,1998
15.7,2915,1,,,15.7,1036,1,,1879
15.72,3007,1,,,15.72,1061,1,,1946
15.74,2945,1,,,15.74,1089,1,,1856
15.76,2994,1,,,15.76,1041,1,,1953
15.78,2988,1,,,15.78,1030,1,,1958
15.8,2962,1,,,15.8,1082,1,,1880
15.82,3026,1,,,15.82,1061,1,,1965
15.84,2947,1,,,15.84,1062,1,,1885
15.86,2977,1,,,15.86,1091,1,,1886
15.88,3027,1,,,15.88,1002,1,,2025
15.9,3012,1,,,15.9,1097,1,,1915
15.92,2925,1,,,15.92,1112,1,,1813
15.94,2969,1,,,15.94,1109,1,,1860
15.96,3077,1,,,15.96,1130,1,,1947
15.98,2895,1,,,15.98,1082,1,,1813
16,2966,1,,,16,1036,1,,1930
16.02,2974,1,,,16.02,1047,1,,1927
16.04,2940,1,,,16.04,1150,1,,1790
16.06,3084,1,,,16.06,1152,1,,1932
16.08,2991,1,,,16.08,1086,1,,1905
16.1,3033,1,,,16.1,1179,1,,1854
16.12,3009,1,,,16.12,1129,1,,1880
16.14,3051,1,,,16.14,1173,1,,1878
16.16,2987,1,,,16.16,1175,1,,1812
16.18,2952,1,,,16.18,1133,1,,1819
16.2,3008,1,,,16.2,1124,1,,1884
16.22,2991,1,,,16.22,1131,1,,1860
16.24,3047,1,,,16.24,1114,1,,1933
16.26,3075,1,,,16.26,1158,1,,1917
16.28,3118,1,,,16.28,1198,1,,1920
16.3,3068,1,,,16.3,1142,1,,1926
16.32,3109,1,,,16.32,1229,1,,1880
16.34,3001,1,,,16.34,1178,1,,1823
16.36,2963,1,,,16.36,1187,1,,1776
16.38,3035,1,,,16.38,1097,1,,1938
16.4,3066,1,,,16.4,1181,1,,1885
16.42,3019,1,,,16.42,1210,1,,1809
16.44,3065,1,,,16.44,1198,1,,1867
16.46,3068,1,,,16.46,1170,1,,1898
16.48,3094,1,,,16.48,1175,1,,1919
16.5,3154,1,,,16.5,1195,1,,1959
16.52,3126,1,,,16.52,1273,1,,1853
16.54,3097,1,,,16.54,1183,1,,1914
16.56,3181,1,,,16.56,1204,1,,1977
16.58,3118,1,,,16.58,1215,1,,1903
16.6,3157,1,,,16.6,1171,1,,1986
16.62,3104,1,,,16.62,1154,1,,1950
16.64,3089,1,,,16.64,1212,1,,1877
16.66,3133,1,,,16.66,1244,1,,1889
16.68,3105,1,,,16.68,1295,1,,1810
16.7,3128,1,,,16.7,1239,1,,1889
16.72,3160,1,,,16.72,1265,1,,1895
16.74,3197,1,,,16.74,1243,1,,1954
16.76,3198,1,,,16.76,1233,1,,1965
16.78,3214,1,,,16.78,1237,1,,1977
16.8,3271,1,,,16.8,1259,1,,2012
16.82,3249,1,,,16.82,1237,1,,2012
16.84,3148,1,,,16.84,1268,1,,1880
16.86,3285,1,,,16.86,1265,1,,2020
16.88,3191,1,,,16.88,1210,1,,1981
16.9,3317,1,,,16.9,1240,1,,2077
16.92,3431,1,,,16.92,1251,1,,2180
16.94,3473,1,,,16.94,1291,1,,2182
16.96,3502,1,,,16.96,1324,1,,2178
16.98,3529,1,,,16.98,1267,1,,2262
17,3541,1,,,17,1300,1,,2241
17.02,3591,1,,,17.02,1274,1,,2317
17.04,3589,1,,,17.04,1278,1,,2311
17.06,3624,1,,,17.06,1328,1,,2296
17.08,3745,1,,,17.08,1360,1,,2385
17.1,3916,1,,,17.1,1306,1,,2610
17.12,3980,1,,,17.12,1325,1,,2655
17.14,4088,1,,,17.14,1313,1,,2775
17.16,4244,1,,,17.16,1306,1,,2938
17.18,4379,1,,,17.18,1378,1,,3001
17.2,4586,1,,,17.2,1409,1,,3177
17.22,4745,1,,,17.22,1266,1,,3479
17.24,4991,1,,,17.24,1325,1,,3666
17.26,5371,1,,,17.26,1292,1,,4079
17.28,5803,1,,,17.28,1248,1,,4555
17.3,6198,1,,,17.3,1403,1,,4795
17.32,6725,1,,,17.32,1399,1,,5326
17.34,7411,1,,,17.34,1348,1,,6063
17.36,8088,1,,,17.36,1335,1,,6753
17.38,8830,1,,,17.38,1357,1,,7473
17.4,9448,1,,,17.4,1345,1,,8103
17.42,10107,1,,,17.42,1410,1,,8697
17.44,10829,1,,,17.44,1362,1,,9467
17.46,11446,1,,,17.46,1368,1,,10078
17.48,12069,1,,,17.48,1447,1,,10622
17.5,12333,1,,,17.5,1402,1,,10931
17.52,12418,1,,,17.52,1358,1,,11060
17.54,12699,1,,,17.54,1419,1,,11280
17.56,12734,1,,,17.56,1385,1,,11349
17.58,12843,1,,,17.58,1413,1,,11430
17.6,13027,1,,,17.6,1459,1,,11568
17.62,13222,1,,,17.62,1434,1,,11788
17.64,13253,1,,,17.64,1301,1,,11952
17.66,13235,1,,,17.66,1407,1,,11828
17.68,12908,1,,,17.68,1511,1,,11397
17.7,12117,1,,,17.7,1434,1,,10683
17.72,11358,1,,,17.72,1446,1,,9912
17.74,10448,1,,,17.74,1383,1,,9065
17.76,9309,1,,,17.76,1361,1,,7948
17.78,8276,1,,,17.78,1454,1,,6822
17.8,7346,1,,,17.8,1447,1,,5899
17.82,6564,1,,,17.82,1469,1,,5095
17.84,5928,1,,,17.84,1442,1,,4486
17.86,5456,1,,,17.86,1485,1,,3971
17.88,5018,1,,,17.88,1504,1,,3514
17.9,4720,1,,,17.9,1441,1,,3279
17.92,4598,1,,,17.92,1495,1,,3103
17.94,4299,1,,,17.94,1497,1,,2802
17.96,4314,1,,,17.96,1489,1,,2825
17.98,4302,1,,,17.98,1506,1,,2796
18,4189,1,,,18,1503,1,,2686
18.02,4152,1,,,18.02,1470,1,,2682
18.04,4005,1,,,18.04,1486,1,,2519
18.06,3974,1,,,18.06,1501,1,,2473
18.08,3934,1,,,18.08,1554,1,,2380
18.1,3964,1,,,18.1,1505,1,,2459
18.12,3900,1,,,18.12,1548,1,,2352
18.14,3940,1,,,18.14,1547,1,,2393
18.16,3960,1,,,18.16,1544,1,,2416
18.18,3852,1,,,18.18,1536,1,,2316
18.2,3833,1,,,18.2,1515,1,,2318
18.22,3794,1,,,18.22,1586,1,,2208
18.24,3799,1,,,18.24,1522,1,,2277
18.26,3789,1,,,18.26,1545,1,,2244
18.28,3816,1,,,18.28,1564,1,,2252
18.3,3787,1,,,18.3,1581,1,,2206
18.32,3842,1,,,18.32,1558,1,,2284
18.34,3878,1,,,18.34,1573,1,,2305
18.36,3779,1,,,18.36,1603,1,,2176
18.38,3829,1,,,18.38,1627,1,,2202
18.4,3825,1,,,18.4,1605,1,,2220
18.42,3843,1,,,18.42,1571,1,,2272
18.44,3824,1,,,18.44,1585,1,,2239
18.46,3831,1,,,18.46,1549,1,,2282
18.48,3866,1,,,18.48,1628,1,,2238
18.5,3883,1,,,18.5,1666,1,,2217
18.52,3830,1,,,18.52,1653,1,,2177
18.54,3923,1,,,18.54,1587,1,,2336
18.56,3931,1,,,18.56,1584,1,,2347
18.58,3805,1,,,18.58,1606,1,,2199
18.6,3850,1,,,18.6,1625,1,,2225
18.62,3906,1,,,18.62,1658,1,,2248
18.64,3897,1,,,18.64,1657,1,,2240
18.66,3896,1,,,18.66,1622,1,,2274
18.68,3779,1,,,18.68,1664,1,,2115
18.7,3811,1,,,18.7,1622,1,,2189
18.72,3813,1,,,18.72,1676,1,,2137
18.74,3910,1,,,18.74,1686,1,,2224
18.76,3935,1,,,18.76,1630,1,,2305
18.78,3905,1,,,18.78,1634,1,,2271
18.8,3942,1,,,18.8,1674,1,,2268
18.82,4066,1,,,18.82,1589,1,,2477
18.84,3988,1,,,18.84,1620,1,,2368
18.86,3961,1,,,18.86,1703,1,,2258
18.88,3917,1,,,18.88,1675,1,,2242
18.9,3932,1,,,18.9,1769,1,,2163
18.92,3965,1,,,18.92,1655,1,,2310
18.94,3928,1,,,18.94,1669,1,,2259
18.96,3993,1,,,18.96,1701,1,,2292
18.98,4013,1,,,18.98,1708,1,,2305
19,4082,1,,,19,1770,1,,2312
19.02,4062,1,,,19.02,1790,1,,2272
19.04,3986,1,,,19.04,1790,1,,2196
19.06,4055,1,,,19.06,1731,1,,2324
19.08,3952,1,,,19.08,1718,1,,2234
19.1,3953,1,,,19.1,1824,1,,2129
19.12,4050,1,,,19.12,1842,1,,2208
19.14,4063,1,,,19.14,1745,1,,2318
19.16,4161,1,,,19.16,1757,1,,2404
19.18,4150,1,,,19.18,1730,1,,2420
19.2,4240,1,,,19.2,1754,1,,2486
19.22,4276,1,,,19.22,1722,1,,2554
19.24,4206,1,,,19.24,1792,1,,2414
19.26,4195,1,,,19.26,1768,1,,2427
19.28,4331,1,,,19.28,1772,1,,2559
19.3,4378,1,,,19.3,1803,1,,2575
19.32,4479,1,,,19.32,1838,1,,2641
19.34,4513,1,,,19.34,1887,1,,2626
19.36,4544,1,,,19.36,1821,1,,2723
19.38,4571,1,,,19.38,1787,1,,2784
19.4,4508,1,,,19.4,1768,1,,2740
19.42,4649,1,,,19.42,1862,1,,2787
19.44,4648,1,,,19.44,1824,1,,2824
19.46,4724,1,,,19.46,1827,1,,2897
19.48,4738,1,,,19.48,1912,1,,2826
19.5,4859,1,,,19.5,1858,1,,3001
19.52,4797,1,,,19.52,1839,1,,2958
19.54,4582,1,,,19.54,1759,1,,2823
19.56,4616,1,,,19.56,1875,1,,2741
19.58,4688,1,,,19.58,1878,1,,2810
19.6,4644,1,,,19.6,1887,1,,2757
19.62,4729,1,,,19.62,1891,1,,2838
19.64,4762,1,,,19.64,1785,1,,2977
19.66,4831,1,,,19.66,1896,1,,2935
19.68,4982,1,,,19.68,1861,1,,3121
19.7,4869,1,,,19.7,1959,1,,2910
19.72,4965,1,,,19.72,1811,1,,3154
19.74,4957,1,,,19.74,1916,1,,3041
19.76,5006,1,,,19.76,1960,1,,3046
19.78,4821,1,,,19.78,1934,1,,2887
19.8,4829,1,,,19.8,1937,1,,2892
19.82,4815,1,,,19.82,1885,1,,2930
19.84,4957,1,,,19.84,1941,1,,3016
19.86,4831,1,,,19.86,1911,1,,2920
19.88,4869,1,,,19.88,1882,1,,2987
19.9,4770,1,,,19.9,1958,1,,2812
19.92,4816,1,,,19.92,1977,1,,2839
19.94,4805,1,,,19.94,1966,1,,2839
19.96,4931,1,,,19.96,1956,1,,2975
19.98,4946,1,,,19.98,1913,1,,3033
20,4960,1,,,20,1967,1,,2993
20.02,5083,1,,,20.02,1932,1,,3151
20.04,5290,1,,,20.04,1928,1,,3362
20.06,5270,1,,,20.06,2037,1,,3233
20.08,5308,1,,,20.08,2008,1,,3300
20.1,5474,1,,,20.1,1973,1,,3501
20.12,5621,1,,,20.12,1990,1,,3631
20.14,5871,1,,,20.14,2018,1,,3853
20.16,5998,1,,,20.16,1979,1,,4019
20.18,6083,1,,,20.18,2066,1,,4017
20.2,6338,1,,,20.2,2047,1,,4291
20.22,6778,1,,,20.22,2034,1,,4744
20.24,7042,1,,,20.24,2036,1,,5006
20.26,7428,1,,,20.26,1995,1,,5433
20.28,8028,1,,,20.28,2039,1,,5989
20.3,8793,1,,,20.3,2071,1,,6722
20.32,9257,1,,,20.32,2032,1,,7225
20.34,9870,1,,,20.34,2109,1,,7761
20.36,10527,1,,,20.36,2120,1,,8407
20.38,11170,1,,,20.38,2072,1,,9098
20.4,11457,1,,,20.4,2026,1,,9431
20.42,11863,1,,,20.42,2058,1,,9805
20.44,12066,1,,,20.44,2034,1,,10032
20.46,12114,1,,,20.46,2019,1,,10095
20.48,12235,1,,,20.48,2053,1,,10182
20.5,12130,1,,,20.5,2055,1,,10075
20.52,12265,1,,,20.52,2085,1,,10180
20.54,12502,1,,,20.54,2040,1,,10462
20.56,12619,1,,,20.56,2025,1,,10594
20.58,12998,1,,,20.58,2045,1,,10953
20.6,13188,1,,,20.6,2104,1,,11084
20.62,13458,1,,,20.62,2176,1,,11282
20.64,13709,1,,,20.64,2190,1,,11519
20.66,13691,1,,,20.66,2099,1,,11592
20.68,13301,1,,,20.68,2119,1,,11182
20.7,12424,1,,,20.7,2124,1,,10300
20.72,11734,1,,,20.72,2116,1,,9618
20.74,10812,1,,,20.74,2127,1,,8685
20.76,9733,1,,,20.76,2175,1,,7558
20.78,8876,1,,,20.78,2105,1,,6771
20.8,7956,1,,,20.8,2097,1,,5859
20.82,7319,1,,,20.82,2119,1,,5200
20.84,6771,1,,,20.84,2080,1,,4691
20.86,6407,1,,,20.86,2157,1,,4250
20.88,6067,1,,,20.88,2169,1,,3898
20.9,5959,1,,,20.9,2179,1,,3780
20.92,5788,1,,,20.92,2246,1,,3542
20.94,5571,1,,,20.94,2132,1,,3439
20.96,5536,1,,,20.96,2078,1,,3458
20.98,5504,1,,,20.98,2132,1,,3372
21,5392,1,,,21,2205,1,,3187
21.02,5413,1,,,21.02,2219,1,,3194
21.04,5266,1,,,21.04,2261,1,,3005
21.06,5222,1,,,21.06,2174,1,,3048
21.08,5116,1,,,21.08,2191,1,,2925
21.1,5158,1,,,21.1,2211,1,,2947
21.12,5196,1,,,21.12,2208,1,,2988
21.14,5107,1,,,21.14,2166,1,,2941
21.16,5074,1,,,21.16,2211,1,,2863
21.18,5168,1,,,21.18,2232,1,,2936
21.2,5070,1,,,21.2,2185,1,,2885
21.22,5245,1,,,21.22,2214,1,,3031
21.24,5207,1,,,21.24,2248,1,,2959
21.26,5116,1,,,21.26,2250,1,,2866
21.28,5122,1,,,21.28,2224,1,,2898
21.3,5113,1,,,21.3,2208,1,,2905
21.32,5176,1,,,21.32,2230,1,,2946
21.34,5248,1,,,21.34,2193,1,,3055
21.36,5063,1,,,21.36,2216,1,,2847
21.38,5193,1,,,21.38,2126,1,,3067
21.4,5174,1,,,21.4,2220,1,,2954
21.42,5225,1,,,21.42,2214,1,,3011
21.44,5277,1,,,21.44,2224,1,,3053
21.46,5163,1,,,21.46,2235,1,,2928
21.48,5171,1,,,21.48,2254,1,,2917
21.5,5254,1,,,21.5,2327,1,,2927
21.52,5243,1,,,21.52,2202,1,,3041
21.54,5247,1,,,21.54,2258,1,,2989
21.56,5248,1,,,21.56,2263,1,,2985
21.58,5226,1,,,21.58,2263,1,,2963
21.6,5213,1,,,21.6,2291,1,,2922
21.62,5209,1,,,21.62,2337,1,,2872
21.64,5249,1,,,21.64,2342,1,,2907
21.66,5253,1,,,21.66,2248,1,,3005
21.68,5372,1,,,21.68,2290,1,,3082
21.7,5238,1,,,21.7,2305,1,,2933
21.72,5264,1,,,21.72,2239,1,,3025
21.74,5241,1,,,21.74,2257,1,,2984
21.76,5323,1,,,21.76,2276,1,,3047
21.78,5295,1,,,21.78,2370,1,,2925
21.8,5319,1,,,21.8,2329,1,,2990
21.82,5447,1,,,21.82,2262,1,,3185
21.84,5385,1,,,21.84,2270,1,,3115
21.86,5428,1,,,21.86,2232,1,,3196
21.88,5328,1,,,21.88,2319,1,,3009
21.9,5363,1,,,21.9,2348,1,,3015
21.92,5448,1,,,21.92,2301,1,,3147
21.94,5364,1,,,21.94,2289,1,,3075
21.96,5321,1,,,21.96,2312,1,,3009
21.98,5234,1,,,21.98,2351,1,,2883
22,5181,1,,,22,2401,1,,2780
22.02,5209,1,,,22.02,2340,1,,2869
22.04,5278,1,,,22.04,2332,1,,2946
22.06,5224,1,,,22.06,2392,1,,2832
22.08,5309,1,,,22.08,2373,1,,2936
22.1,5343,1,,,22.1,2328,1,,3015
22.12,5262,1,,,22.12,2291,1,,2971
22.14,5217,1,,,22.14,2348,1,,2869
22.16,5361,1,,,22.16,2319,1,,3042
22.18,5435,1,,,22.18,2345,1,,3090
22.2,5348,1,,,22.2,2357,1,,2991
22.22,5267,1,,,22.22,2368,1,,2899
22.24,5353,1,,,22.24,2375,1,,2978
22.26,5312,1,,,22.26,2387,1,,2925
22.28,5338,1,,,22.28,2376,1,,2962
22.3,5371,1,,,22.3,2389,1,,2982
22.32,5228,1,,,22.32,2380,1,,2848
22.34,5356,1,,,22.34,2297,1,,3059
22.36,5353,1,,,22.36,2385,1,,2968
22.38,5383,1,,,22.38,2351,1,,3032
22.4,5336,1,,,22.4,2431,1,,2905
22.42,5529,1,,,22.42,2328,1,,3201
22.44,5512,1,,,22.44,2362,1,,3150
22.46,5529,1,,,22.46,2491,1,,3038
22.48,5530,1,,,22.48,2400,1,,3130
22.5,5721,1,,,22.5,2346,1,,3375
22.52,5703,1,,,22.52,2339,1,,3364
22.54,5708,1,,,22.54,2398,1,,3310
22.56,5527,1,,,22.56,2462,1,,3065
22.58,5721,1,,,22.58,2443,1,,3278
22.6,5808,1,,,22.6,2313,1,,3495
22.62,5724,1,,,22.62,2380,1,,3344
22.64,5682,1,,,22.64,2336,1,,3346
22.66,5642,1,,,22.66,2352,1,,3290
22.68,5550,1,,,22.68,2337,1,,3213
22.7,5597,1,,,22.7,2435,1,,3162
22.72,5623,1,,,22.72,2458,1,,3165
22.74,5641,1,,,22.74,2418,1,,3223
22.76,5606,1,,,22.76,2452,1,,3154
22.78,5544,1,,,22.78,2389,1,,3155
22.8,5718,1,,,22.8,2368,1,,3350
22.82,5559,1,,,22.82,2447,1,,3112
22.84,5633,1,,,22.84,2396,1,,3237
22.86,5614,1,,,22.86,2358,1,,3256
22.88,5645,1,,,22.88,2367,1,,3278
22.9,5561,1,,,22.9,2348,1,,3213
22.92,5512,1,,,22.92,2428,1,,3084
22.94,5556,1,,,22.94,2407,1,,3149
22.96,5637,1,,,22.96,2462,1,,3175
22.98,5532,1,,,22.98,2425,1,,3107
23,5680,1,,,23,2477,1,,3203
23.02,5812,1,,,23.02,2442,1,,3370
23.04,5841,1,,,23.04,2454,1,,3387
23.06,5940,1,,,23.06,2449,1,,3491
23.08,5940,1,,,23.08,2449,1,,3491
23.1,5906,1,,,23.1,2403,1,,3503
23.12,5981,1,,,23.12,2398,1,,3583
23.14,6062,1,,,23.14,2478,1,,3584
23.16,6130,1,,,23.16,2388,1,,3742
23.18,6259,1,,,23.18,2459,1,,3800
23.2,6489,1,,,23.2,2407,1,,4082
23.22,6637,1,,,23.22,2414,1,,4223
23.24,6726,1,,,23.24,2431,1,,4295
23.26,6996,1,,,23.26,2413,1,,4583
23.28,7250,1,,,23.28,2401,1,,4849
23.3,7482,1,,,23.3,2408,1,,5074
23.32,7661,1,,,23.32,2503,1,,5158
23.34,7928,1,,,23.34,2427,1,,5501
23.36,8159,1,,,23.36,2445,1,,5714
23.38,8381,1,,,23.38,2471,1,,5910
23.4,8311,1,,,23.4,2320,1,,5991
23.42,8295,1,,,23.42,2400,1,,5895
23.44,8235,1,,,23.44,2529,1,,5706
23.46,8221,1,,,23.46,2445,1,,5776
23.48,8126,1,,,23.48,2504,1,,5622
23.5,8183,1,,,23.5,2508,1,,5675
23.52,8233,1,,,23.52,2475,1,,5758
23.54,8193,1,,,23.54,2420,1,,5773
23.56,8376,1,,,23.56,2505,1,,5871
23.58,8430,1,,,23.58,2489,1,,5941
23.6,8755,1,,,23.6,2460,1,,6295
23.62,8713,1,,,23.62,2531,1,,6182
23.64,8806,1,,,23.64,2460,1,,6346
23.66,8855,1,,,23.66,2415,1,,6440
23.68,8790,1,,,23.68,2431,1,,6359
23.7,8440,1,,,23.7,2478,1,,5962
23.72,8180,1,,,23.72,2514,1,,5666
23.74,7882,1,,,23.74,2508,1,,5374
23.76,7527,1,,,23.76,2417,1,,5110
23.78,7105,1,,,23.78,2368,1,,4737
23.8,6866,1,,,23.8,2493,1,,4373
23.82,6510,1,,,23.82,2480,1,,4030
23.84,6296,1,,,23.84,2451,1,,3845
23.86,6165,1,,,23.86,2424,1,,3741
23.88,6187,1,,,23.88,2553,1,,3634
23.9,6046,1,,,23.9,2495,1,,3551
23.92,5976,1,,,23.92,2409,1,,3567
23.94,5797,1,,,23.94,2496,1,,3301
23.96,5668,1,,,23.96,2543,1,,3125
23.98,5650,1,,,23.98,2532,1,,3118
24,5534,1,,,24,2517,1,,3017
24.02,5750,1,,,24.02,2492,1,,3258
24.04,5502,1,,,24.04,2439,1,,3063
24.06,5464,1,,,24.06,2455,1,,3009
24.08,5672,1,,,24.08,2446,1,,3226
24.1,5479,1,,,24.1,2427,1,,3052
24.12,5573,1,,,24.12,2442,1,,3131
24.14,5540,1,,,24.14,2434,1,,3106
24.16,5522,1,,,24.16,2423,1,,3099
24.18,5466,1,,,24.18,2426,1,,3040
24.2,5533,1,,,24.2,2490,1,,3043
24.22,5441,1,,,24.22,2448,1,,2993
24.24,5540,1,,,24.24,2396,1,,3144
24.26,5695,1,,,24.26,2488,1,,3207
24.28,5526,1,,,24.28,2500,1,,3026
24.3,5549,1,,,24.3,2444,1,,3105
24.32,5608,1,,,24.32,2466,1,,3142
24.34,5535,1,,,24.34,2425,1,,3110
24.36,5467,1,,,24.36,2546,1,,2921
24.38,5498,1,,,24.38,2414,1,,3084
24.4,5542,1,,,24.4,2408,1,,3134
24.42,5547,1,,,24.42,2423,1,,3124
24.44,5516,1,,,24.44,2439,1,,3077
24.46,5536,1,,,24.46,2443,1,,3093
24.48,5578,1,,,24.48,2420,1,,3158
24.5,5646,1,,,24.5,2453,1,,3193
24.52,5644,1,,,24.52,2482,1,,3162
24.54,5420,1,,,24.54,2427,1,,2993
24.56,5484,1,,,24.56,2472,1,,3012
24.58,5547,1,,,24.58,2485,1,,3062
24.6,5483,1,,,24.6,2460,1,,3023
24.62,5554,1,,,24.62,2461,1,,3093
24.64,5555,1,,,24.64,2523,1,,3032
24.66,5490,1,,,24.66,2448,1,,3042
24.68,5452,1,,,24.68,2500,1,,2952
24.7,5369,1,,,24.7,2510,1,,2859
24.72,5604,1,,,24.72,2530,1,,3074
24.74,5552,1,,,24.74,2497,1,,3055
24.76,5460,1,,,24.76,2504,1,,2956
24.78,5511,1,,,24.78,2485,1,,3026
24.8,5479,1,,,24.8,2478,1,,3001
24.82,5544,1,,,24.82,2500,1,,3044
24.84,5680,1,,,24.84,2493,1,,3187
24.86,5587,1,,,24.86,2481,1,,3106
24.88,5744,1,,,24.88,2516,1,,3228
24.9,5683,1,,,24.9,2495,1,,3188
24.92,5666,1,,,24.92,2396,1,,3270
24.94,5583,1,,,24.94,2475,1,,3108
24.96,5519,1,,,24.96,2468,1,,3051
24.98,5539,1,,,24.98,2507,1,,3032
25,5607,1,,,25,2470,1,,3137
25.02,5475,1,,,25.02,2465,1,,3010
25.04,5467,1,,,25.04,2477,1,,2990
25.06,5491,1,,,25.06,2461,1,,3030
25.08,5460,1,,,25.08,2373,1,,3087
25.1,5508,1,,,25.1,2453,1,,3055
25.12,5425,1,,,25.12,2387,1,,3038
25.14,5404,1,,,25.14,2453,1,,2951
25.16,5349,1,,,25.16,2490,1,,2859
25.18,5428,1,,,25.18,2412,1,,3016
25.2,5430,1,,,25.2,2414,1,,3016
25.22,5439,1,,,25.22,2505,1,,2934
25.24,5433,1,,,25.24,2475,1,,2958
25.26,5458,1,,,25.26,2425,1,,3033
25.28,5489,1,,,25.28,2387,1,,3102
25.3,5504,1,,,25.3,2450,1,,3054
25.32,5375,1,,,25.32,2425,1,,2950
25.34,5285,1,,,25.34,2469,1,,2816
25.36,5434,1,,,25.36,2457,1,,2977
25.38,5413,1,,,25.38,2438,1,,2975
25.4,5502,1,,,25.4,2383,1,,3119
25.42,5409,1,,,25.42,2415,1,,2994
25.44,5409,1,,,25.44,2492,1,,2917
25.46,5326,1,,,25.46,2525,1,,2801
25.48,5350,1,,,25.48,2290,1,,3060
25.5,5348,1,,,25.5,2425,1,,2923
25.52,5393,1,,,25.52,2446,1,,2947
25.54,5471,1,,,25.54,2503,1,,2968
25.56,5433,1,,,25.56,2405,1,,3028
25.58,5405,1,,,25.58,2398,1,,3007
25.6,5435,1,,,25.6,2477,1,,2958
25.62,5384,1,,,25.62,2456,1,,2928
25.64,5408,1,,,25.64,2453,1,,2955
25.66,5422,1,,,25.66,2428,1,,2994
25.68,5426,1,,,25.68,2395,1,,3031
25.7,5540,1,,,25.7,2473,1,,3067
25.72,5565,1,,,25.72,2435,1,,3130
25.74,5552,1,,,25.74,2418,1,,3134
25.76,5479,1,,,25.76,2420,1,,3059
25.78,5492,1,,,25.78,2448,1,,3044
25.8,5594,1,,,25.8,2387,1,,3207
25.82,5493,1,,,25.82,2319,1,,3174
25.84,5505,1,,,25.84,2332,1,,3173
25.86,5582,1,,,25.86,2441,1,,3141
25.88,5511,1,,,25.88,2330,1,,3181
25.9,5593,1,,,25.9,2367,1,,3226
25.92,5645,1,,,25.92,2334,1,,3311
25.94,5687,1,,,25.94,2304,1,,3383
25.96,5649,1,,,25.96,2356,1,,3293
25.98,5710,1,,,25.98,2401,1,,3309
26,5642,1,,,26,2402,1,,3240
26.02,5690,1,,,26.02,2425,1,,3265
26.04,5834,1,,,26.04,2360,1,,3474
26.06,5595,1,,,26.06,2418,1,,3177
26.08,5959,1,,,26.08,2399,1,,3560
26.1,5871,1,,,26.1,2433,1,,3438
26.12,5886,1,,,26.12,2376,1,,3510
26.14,6099,1,,,26.14,2381,1,,3718
26.16,6207,1,,,26.16,2423,1,,3784
26.18,6465,1,,,26.18,2411,1,,4054
26.2,6632,1,,,26.2,2481,1,,4151
26.22,6693,1,,,26.22,2418,1,,4275
26.24,6858,1,,,26.24,2342,1,,4516
26.26,7092,1,,,26.26,2396,1,,4696
26.28,7237,1,,,26.28,2356,1,,4881
26.3,7442,1,,,26.3,2395,1,,5047
26.32,7687,1,,,26.32,2358,1,,5329
26.34,7688,1,,,26.34,2440,1,,5248
26.36,7720,1,,,26.36,2437,1,,5283
26.38,7843,1,,,26.38,2340,1,,5503
26.4,7748,1,,,26.4,2407,1,,5341
26.42,7623,1,,,26.42,2410,1,,5213
26.44,7391,1,,,26.44,2376,1,,5015
26.46,7493,1,,,26.46,2414,1,,5079
26.48,7226,1,,,26.48,2412,1,,4814
26.5,7318,1,,,26.5,2373,1,,4945
26.52,7316,1,,,26.52,2342,1,,4974
26.54,7479,1,,,26.54,2397,1,,5082
26.56,7384,1,,,26.56,2399,1,,4985
26.58,7609,1,,,26.58,2330,1,,5279
26.6,7755,1,,,26.6,2317,1,,5438
26.62,7867,1,,,26.62,2277,1,,5590
26.64,7942,1,,,26.64,2336,1,,5606
26.66,8163,1,,,26.66,2329,1,,5834
26.68,8299,1,,,26.68,2285,1,,6014
26.7,8289,1,,,26.7,2331,1,,5958
26.72,7933,1,,,26.72,2307,1,,5626
26.74,7749,1,,,26.74,2349,1,,5400
26.76,7504,1,,,26.76,2322,1,,5182
26.78,7226,1,,,26.78,2363,1,,4863
26.8,6889,1,,,26.8,2294,1,,4595
26.82,6539,1,,,26.82,2302,1,,4237
26.84,6283,1,,,26.84,2296,1,,3987
26.86,6028,1,,,26.86,2360,1,,3668
26.88,5994,1,,,26.88,2265,1,,3729
26.9,5819,1,,,26.9,2282,1,,3537
26.92,5892,1,,,26.92,2308,1,,3584
26.94,5839,1,,,26.94,2261,1,,3578
26.96,5870,1,,,26.96,2389,1,,3481
26.98,5784,1,,,26.98,2272,1,,3512
27,5718,1,,,27,2310,1,,3408
27.02,5767,1,,,27.02,2322,1,,3445
27.04,5607,1,,,27.04,2329,1,,3278
27.06,5671,1,,,27.06,2370,1,,3301
27.08,5756,1,,,27.08,2341,1,,3415
27.1,5633,1,,,27.1,2404,1,,3229
27.12,5564,1,,,27.12,2371,1,,3193
27.14,5511,1,,,27.14,2277,1,,3234
27.16,5534,1,,,27.16,2196,1,,3338
27.18,5456,1,,,27.18,2280,1,,3176
27.2,5537,1,,,27.2,2385,1,,3152
27.22,5412,1,,,27.22,2302,1,,3110
27.24,5479,1,,,27.24,2334,1,,3145
27.26,5500,1,,,27.26,2347,1,,3153
27.28,5458,1,,,27.28,2392,1,,3066
27.3,5366,1,,,27.3,2381,1,,2985
27.32,5453,1,,,27.32,2297,1,,3156
27.34,5389,1,,,27.34,2381,1,,3008
27.36,5391,1,,,27.36,2278,1,,3113
27.38,5399,1,,,27.38,2259,1,,3140
27.4,5338,1,,,27.4,2288,1,,3050
27.42,5473,1,,,27.42,2269,1,,3204
27.44,5459,1,,,27.44,2295,1,,3164
27.46,5441,1,,,27.46,2324,1,,3117
27.48,5461,1,,,27.48,2361,1,,3100
27.5,5470,1,,,27.5,2299,1,,3171
27.52,5489,1,,,27.52,2294,1,,3195
27.54,5478,1,,,27.54,2301,1,,3177
27.56,5251,1,,,27.56,2212,1,,3039
27.58,5250,1,,,27.58,2294,1,,2956
27.6,5234,1,,,27.6,2262,1,,2972
27.62,5386,1,,,27.62,2303,1,,3083
27.64,5368,1,,,27.64,2279,1,,3089
27.66,5308,1,,,27.66,2321,1,,2987
27.68,5260,1,,,27.68,2206,1,,3054
27.7,5247,1,,,27.7,2273,1,,2974
27.72,5231,1,,,27.72,2232,1,,2999
27.74,5104,1,,,27.74,2226,1,,2878
27.76,5215,1,,,27.76,2274,1,,2941
27.78,5406,1,,,27.78,2220,1,,3186
27.8,5357,1,,,27.8,2243,1,,3114
27.82,5412,1,,,27.82,2239,1,,3173
27.84,5260,1,,,27.84,2261,1,,2999
27.86,5460,1,,,27.86,2313,1,,3147
27.88,5300,1,,,27.88,2212,1,,3088
27.9,5248,1,,,27.9,2303,1,,2945
27.92,5245,1,,,27.92,2224,1,,3021
27.94,5269,1,,,27.94,2316,1,,2953
27.96,5207,1,,,27.96,2293,1,,2914
27.98,5344,1,,,27.98,2268,1,,3076
28,5261,1,,,28,2189,1,,3072
28.02,5234,1,,,28.02,2219,1,,3015
28.04,5128,1,,,28.04,2257,1,,2871
28.06,5147,1,,,28.06,2287,1,,2860
28.08,5326,1,,,28.08,2257,1,,3069
28.1,5335,1,,,28.1,2214,1,,3121
28.12,5194,1,,,28.12,2235,1,,2959
28.14,5113,1,,,28.14,2205,1,,2908
28.16,5318,1,,,28.16,2290,1,,3028
28.18,5237,1,,,28.18,2248,1,,2989
28.2,5255,1,,,28.2,2187,1,,3068
28.22,5266,1,,,28.22,2221,1,,3045
28.24,5291,1,,,28.24,2228,1,,3063
28.26,5224,1,,,28.26,2178,1,,3046
28.28,5276,1,,,28.28,2168,1,,3108
28.3,5216,1,,,28.3,2185,1,,3031
28.32,5240,1,,,28.32,2217,1,,3023
28.34,5221,1,,,28.34,2264,1,,2957
28.36,5121,1,,,28.36,2215,1,,2906
28.38,5137,1,,,28.38,2191,1,,2946
28.4,5412,1,,,28.4,2225,1,,3187
28.42,5172,1,,,28.42,2207,1,,2965
28.44,5176,1,,,28.44,2206,1,,2970
28.46,5262,1,,,28.46,2201,1,,3061
28.48,5135,1,,,28.48,2161,1,,2974
28.5,5090,1,,,28.5,2216,1,,2874
28.52,5084,1,,,28.52,2226,1,,2858
28.54,5151,1,,,28.54,2151,1,,3000
28.56,5146,1,,,28.56,2149,1,,2997
28.58,5195,1,,,28.58,2210,1,,2985
28.6,5064,1,,,28.6,2186,1,,2878
28.62,5134,1,,,28.62,2129,1,,3005
28.64,4987,1,,,28.64,2099,1,,2888
28.66,5096,1,,,28.66,2248,1,,2848
28.68,5152,1,,,28.68,2126,1,,3026
28.7,5156,1,,,28.7,2201,1,,2955
28.72,5155,1,,,28.72,2151,1,,3004
28.74,5018,1,,,28.74,2191,1,,2827
28.76,5046,1,,,28.76,2229,1,,2817
28.78,5192,1,,,28.78,2128,1,,3064
28.8,5226,1,,,28.8,2202,1,,3024
28.82,5067,1,,,28.82,2175,1,,2892
28.84,5157,1,,,28.84,2131,1,,3026
28.86,5303,1,,,28.86,2120,1,,3183
28.88,5218,1,,,28.88,2133,1,,3085
28.9,5262,1,,,28.9,2188,1,,3074
28.92,5338,1,,,28.92,2170,1,,3168
28.94,5332,1,,,28.94,2157,1,,3175
28.96,5277,1,,,28.96,2173,1,,3104
28.98,5381,1,,,28.98,2211,1,,3170
29,5263,1,,,29,2182,1,,3081
29.02,5218,1,,,29.02,2218,1,,3000
29.04,5368,1,,,29.04,2167,1,,3201
29.06,5379,1,,,29.06,2185,1,,3194
29.08,5356,1,,,29.08,2219,1,,3137
29.1,5379,1,,,29.1,2127,1,,3252
29.12,5314,1,,,29.12,2156,1,,3158
29.14,5433,1,,,29.14,2165,1,,3268
29.16,5511,1,,,29.16,2195,1,,3316
29.18,5529,1,,,29.18,2205,1,,3324
29.2,5565,1,,,29.2,2233,1,,3332
29.22,5719,1,,,29.22,2200,1,,3519
29.24,5796,1,,,29.24,2240,1,,3556
29.26,5937,1,,,29.26,2196,1,,3741
29.28,5972,1,,,29.28,2129,1,,3843
29.3,6032,1,,,29.3,2126,1,,3906
29.32,6184,1,,,29.32,2213,1,,3971
29.34,5946,1,,,29.34,2193,1,,3753
29.36,6196,1,,,29.36,2228,1,,3968
29.38,6251,1,,,29.38,2158,1,,4093
29.4,6123,1,,,29.4,2152,1,,3971
29.42,6024,1,,,29.42,2129,1,,3895
29.44,5935,1,,,29.44,2134,1,,3801
29.46,5869,1,,,29.46,2095,1,,3774
29.48,5908,1,,,29.48,2203,1,,3705
29.5,5885,1,,,29.5,2130,1,,3755
29.52,5867,1,,,29.52,2128,1,,3739
29.54,5725,1,,,29.54,2085,1,,3640
29.56,5792,1,,,29.56,2041,1,,3751
29.58,5837,1,,,29.58,2020,1,,3817
29.6,5821,1,,,29.6,2049,1,,3772
29.62,5955,1,,,29.62,2047,1,,3908
29.64,6028,1,,,29.64,2114,1,,3914
29.66,6068,1,,,29.66,2058,1,,4010
29.68,6083,1,,,29.68,2110,1,,3973
29.7,6245,1,,,29.7,2214,1,,4031
29.72,6312,1,,,29.72,2095,1,,4217
29.74,6260,1,,,29.74,2103,1,,4157
29.76,6289,1,,,29.76,2104,1,,4185
29.78,6313,1,,,29.78,2082,1,,4231
29.8,6112,1,,,29.8,2095,1,,4017
29.82,5830,1,,,29.82,2125,1,,3705
29.84,5695,1,,,29.84,2112,1,,3583
29.86,5635,1,,,29.86,2094,1,,3541
29.88,5496,1,,,29.88,2087,1,,3409
29.9,5358,1,,,29.9,2003,1,,3355
29.92,5401,1,,,29.92,2076,1,,3325
29.94,5278,1,,,29.94,2052,1,,3226
29.96,5365,1,,,29.96,2044,1,,3321
29.98,5269,1,,,29.98,2055,1,,3214
30,5134,1,,,30,2019,1,,3115
30.02,5085,1,,,30.02,2114,1,,2971
30.04,5128,1,,,30.04,2106,1,,3022
30.06,5139,1,,,30.06,2077,1,,3062
30.08,5103,1,,,30.08,2053,1,,3050
30.1,5068,1,,,30.1,2091,1,,2977
30.12,5063,1,,,30.12,2054,1,,3009
30.14,5090,1,,,30.14,2013,1,,3077
30.16,4840,1,,,30.16,2063,1,,2777
30.18,4796,1,,,30.18,2068,1,,2728
30.2,4853,1,,,30.2,2086,1,,2767
30.22,4854,1,,,30.22,2111,1,,2743
30.24,4862,1,,,30.24,2123,1,,2739
30.26,4868,1,,,30.26,2091,1,,2777
30.28,4802,1,,,30.28,2051,1,,2751
30.3,4830,1,,,30.3,2078,1,,2752
30.32,4901,1,,,30.32,2020,1,,2881
30.34,4824,1,,,30.34,1998,1,,2826
30.36,4750,1,,,30.36,2043,1,,2707
30.38,4799,1,,,30.38,1955,1,,2844
30.4,4850,1,,,30.4,1956,1,,2894
30.42,4785,1,,,30.42,1933,1,,2852
30.44,4904,1,,,30.44,2029,1,,2875
30.46,4884,1,,,30.46,2025,1,,2859
30.48,4814,1,,,30.48,2065,1,,2749
30.5,4846,1,,,30.5,2012,1,,2834
30.52,4759,1,,,30.52,2078,1,,2681
30.54,4860,1,,,30.54,2009,1,,2851
30.56,5102,1,,,30.56,1996,1,,3106
30.58,4991,1,,,30.58,1995,1,,2996
30.6,4945,1,,,30.6,1975,1,,2970
30.62,5017,1,,,30.62,2014,1,,3003
30.64,4976,1,,,30.64,2010,1,,2966
30.66,4981,1,,,30.66,1945,1,,3036
30.68,5100,1,,,30.68,2008,1,,3092
30.7,5076,1,,,30.7,1956,1,,3120
30.72,4911,1,,,30.72,2019,1,,2892
30.74,4911,1,,,30.74,1995,1,,2916
30.76,5043,1,,,30.76,2017,1,,3026
30.78,4996,1,,,30.78,1993,1,,3003
30.8,4769,1,,,30.8,1943,1,,2826
30.82,4910,1,,,30.82,2025,1,,2885
30.84,4907,1,,,30.84,1954,1,,2953
30.86,4982,1,,,30.86,1929,1,,3053
30.88,4893,1,,,30.88,1914,1,,2979
30.9,4832,1,,,30.9,1886,1,,2946
30.92,4905,1,,,30.92,2000,1,,2905
30.94,4923,1,,,30.94,1921,1,,3002
30.96,4763,1,,,30.96,1943,1,,2820
30.98,4770,1,,,30.98,1982,1,,2788
31,4698,1,,,31,1944,1,,2754
31.02,4698,1,,,31.02,1950,1,,2748
31.04,4788,1,,,31.04,1994,1,,2794
31.06,4761,1,,,31.06,1955,1,,2806
31.08,4798,1,,,31.08,1891,1,,2907
31.1,4817,1,,,31.1,1895,1,,2922
31.12,4654,1,,,31.12,1976,1,,2678
31.14,4694,1,,,31.14,1876,1,,2818
31.16,4775,1,,,31.16,1960,1,,2815
31.18,4702,1,,,31.18,1922,1,,2780
31.2,4696,1,,,31.2,1902,1,,2794
31.22,4682,1,,,31.22,1881,1,,2801
31.24,4696,1,,,31.24,1977,1,,2719
31.26,4709,1,,,31.26,1955,1,,2754
31.28,4704,1,,,31.28,1919,1,,2785
31.3,4671,1,,,31.3,1905,1,,2766
31.32,4657,1,,,31.32,1896,1,,2761
31.34,4683,1,,,31.34,1888,1,,2795
31.36,4690,1,,,31.36,1866,1,,2824
31.38,4596,1,,,31.38,1885,1,,2711
31.4,4574,1,,,31.4,1889,1,,2685
31.42,4685,1,,,31.42,1882,1,,2803
31.44,4685,1,,,31.44,1884,1,,2801
31.46,4665,1,,,31.46,1887,1,,2778
31.48,4648,1,,,31.48,1829,1,,2819
31.5,4639,1,,,31.5,1894,1,,2745
31.52,4605,1,,,31.52,1863,1,,2742
31.54,4640,1,,,31.54,1866,1,,2774
31.56,4656,1,,,31.56,1856,1,,2800
31.58,4688,1,,,31.58,1900,1,,2788
31.6,4718,1,,,31.6,1871,1,,2847
31.62,4675,1,,,31.62,1827,1,,2848
31.64,4770,1,,,31.64,1835,1,,2935
31.66,4814,1,,,31.66,1911,1,,2903
31.68,4879,1,,,31.68,1844,1,,3035
31.7,4800,1,,,31.7,1848,1,,2952
31.72,4881,1,,,31.72,1813,1,,3068
31.74,4880,1,,,31.74,1866,1,,3014
31.76,4977,1,,,31.76,1863,1,,3114
31.78,4938,1,,,31.78,1856,1,,3082
31.8,4857,1,,,31.8,1855,1,,3002
31.82,4909,1,,,31.82,1802,1,,3107
31.84,4876,1,,,31.84,1841,1,,3035
31.86,4735,1,,,31.86,1856,1,,2879
31.88,4810,1,,,31.88,1794,1,,3016
31.9,4841,1,,,31.9,1882,1,,2959
31.92,4716,1,,,31.92,1840,1,,2876
31.94,4845,1,,,31.94,1836,1,,3009
31.96,4779,1,,,31.96,1848,1,,2931
31.98,4741,1,,,31.98,1821,1,,2920
32,4720,1,,,32,1852,1,,2868
32.02,4714,1,,,32.02,1872,1,,2842
32.04,4769,1,,,32.04,1830,1,,2939
32.06,4749,1,,,32.06,1791,1,,2958
32.08,4727,1,,,32.08,1822,1,,2905
32.1,4708,1,,,32.1,1840,1,,2868
32.12,4703,1,,,32.12,1797,1,,2906
32.14,4783,1,,,32.14,1786,1,,2997
32.16,4820,1,,,32.16,1800,1,,3020
32.18,4895,1,,,32.18,1730,1,,3165
32.2,4895,1,,,32.2,1805,1,,3090
32.22,5039,1,,,32.22,1774,1,,3265
32.24,5161,1,,,32.24,1716,1,,3445
32.26,5146,1,,,32.26,1770,1,,3376
32.28,5272,1,,,32.28,1807,1,,3465
32.3,5284,1,,,32.3,1814,1,,3470
32.32,5332,1,,,32.32,1802,1,,3530
32.34,5494,1,,,32.34,1769,1,,3725
32.36,5527,1,,,32.36,1807,1,,3720
32.38,5455,1,,,32.38,1810,1,,3645
32.4,5432,1,,,32.4,1725,1,,3707
32.42,5338,1,,,32.42,1781,1,,3557
32.44,5254,1,,,32.44,1760,1,,3494
32.46,5373,1,,,32.46,1791,1,,3582
32.48,5273,1,,,32.48,1718,1,,3555
32.5,5273,1,,,32.5,1758,1,,3515
32.52,5146,1,,,32.52,1700,1,,3446
32.54,5142,1,,,32.54,1816,1,,3326
32.56,4977,1,,,32.56,1749,1,,3228
32.58,5012,1,,,32.58,1703,1,,3309
32.6,5239,1,,,32.6,1758,1,,3481
32.62,5063,1,,,32.62,1738,1,,3325
32.64,5207,1,,,32.64,1806,1,,3401
32.66,5169,1,,,32.66,1731,1,,3438
32.68,5149,1,,,32.68,1764,1,,3385
32.7,5246,1,,,32.7,1740,1,,3506
32.72,5424,1,,,32.72,1658,1,,3766
32.74,5253,1,,,32.74,1714,1,,3539
32.76,5335,1,,,32.76,1719,1,,3616
32.78,5476,1,,,32.78,1693,1,,3783
32.8,5452,1,,,32.8,1728,1,,3724
32.82,5357,1,,,32.82,1689,1,,3668
32.84,5326,1,,,32.84,1725,1,,3601
32.86,5315,1,,,32.86,1750,1,,3565
32.88,5258,1,,,32.88,1722,1,,3536
32.9,5178,1,,,32.9,1732,1,,3446
32.92,5056,1,,,32.92,1641,1,,3415
32.94,4989,1,,,32.94,1706,1,,3283
32.96,4899,1,,,32.96,1727,1,,3172
32.98,4982,1,,,32.98,1731,1,,3251
33,4847,1,,,33,1704,1,,3143
33.02,4736,1,,,33.02,1657,1,,3079
33.04,4748,1,,,33.04,1641,1,,3107
33.06,4721,1,,,33.06,1614,1,,3107
33.08,4763,1,,,33.08,1686,1,,3077
33.1,4696,1,,,33.1,1677,1,,3019
33.12,4662,1,,,33.12,1673,1,,2989
33.14,4589,1,,,33.14,1669,1,,2920
33.16,4493,1,,,33.16,1686,1,,2807
33.18,4498,1,,,33.18,1655,1,,2843
33.2,4453,1,,,33.2,1689,1,,2764
33.22,4552,1,,,33.22,1674,1,,2878
33.24,4466,1,,,33.24,1623,1,,2843
33.26,4549,1,,,33.26,1647,1,,2902
33.28,4343,1,,,33.28,1672,1,,2671
33.3,4344,1,,,33.3,1656,1,,2688
33.32,4395,1,,,33.32,1662,1,,2733
33.34,4469,1,,,33.34,1622,1,,2847
33.36,4301,1,,,33.36,1606,1,,2695
33.38,4353,1,,,33.38,1614,1,,2739
33.4,4259,1,,,33.4,1644,1,,2615
33.42,4267,1,,,33.42,1620,1,,2647
33.44,4343,1,,,33.44,1593,1,,2750
33.46,4345,1,,,33.46,1631,1,,2714
33.48,4324,1,,,33.48,1618,1,,2706
33.5,4277,1,,,33.5,1644,1,,2633
33.52,4196,1,,,33.52,1613,1,,2583
33.54,4244,1,,,33.54,1644,1,,2600
33.56,4150,1,,,33.56,1597,1,,2553
33.58,4246,1,,,33.58,1618,1,,2628
33.6,4289,1,,,33.6,1559,1,,2730
33.62,4117,1,,,33.62,1616,1,,2501
33.64,4235,1,,,33.64,1611,1,,2624
33.66,4177,1,,,33.66,1573,1,,2604
33.68,4203,1,,,33.68,1642,1,,2561
33.7,4209,1,,,33.7,1589,1,,2620
33.72,4251,1,,,33.72,1575,1,,2676
33.74,4222,1,,,33.74,1552,1,,2670
33.76,4277,1,,,33.76,1595,1,,2682
33.78,4174,1,,,33.78,1577,1,,2597
33.8,4099,1,,,33.8,1602,1,,2497
33.82,4194,1,,,33.82,1618,1,,2576
33.84,4229,1,,,33.84,1561,1,,2668
33.86,4249,1,,,33.86,1572,1,,2677
33.88,4290,1,,,33.88,1626,1,,2664
33.9,4184,1,,,33.9,1573,1,,2611
33.92,4329,1,,,33.92,1496,1,,2833
33.94,4240,1,,,33.94,1537,1,,2703
33.96,4227,1,,,33.96,1528,1,,2699
33.98,4132,1,,,33.98,1564,1,,2568
34,4089,1,,,34,1540,1,,2549
34.02,4191,1,,,34.02,1549,1,,2642
34.04,4188,1,,,34.04,1547,1,,2641
34.06,4147,1,,,34.06,1577,1,,2570
34.08,4096,1,,,34.08,1613,1,,2483
34.1,4017,1,,,34.1,1563,1,,2454
34.12,4156,1,,,34.12,1546,1,,2610
34.14,4110,1,,,34.14,1470,1,,2640
34.16,4108,1,,,34.16,1544,1,,2564
34.18,4129,1,,,34.18,1485,1,,2644
34.2,4088,1,,,34.2,1488,1,,2600
34.22,4055,1,,,34.22,1526,1,,2529
34.24,4044,1,,,34.24,1535,1,,2509
34.26,4027,1,,,34.26,1480,1,,2547
34.28,4069,1,,,34.28,1519,1,,2550
34.3,3954,1,,,34.3,1484,1,,2470
34.32,3997,1,,,34.32,1514,1,,2483
34.34,4028,1,,,34.34,1498,1,,2530
34.36,4071,1,,,34.36,1486,1,,2585
34.38,3963,1,,,34.38,1508,1,,2455
34.4,3967,1,,,34.4,1430,1,,2537
34.42,4065,1,,,34.42,1454,1,,2611
34.44,3974,1,,,34.44,1515,1,,2459
34.46,3929,1,,,34.46,1513,1,,2416
34.48,3974,1,,,34.48,1416,1,,2558
34.5,3999,1,,,34.5,1525,1,,2474
34.52,3916,1,,,34.52,1548,1,,2368
34.54,3957,1,,,34.54,1412,1,,2545
34.56,4045,1,,,34.56,1447,1,,2598
34.58,3992,1,,,34.58,1491,1,,2501
34.6,3944,1,,,34.6,1498,1,,2446
34.62,4017,1,,,34.62,1481,1,,2536
34.64,3984,1,,,34.64,1479,1,,2505
34.66,3988,1,,,34.66,1420,1,,2568
34.68,3935,1,,,34.68,1448,1,,2487
34.7,3957,1,,,34.7,1434,1,,2523
34.72,3916,1,,,34.72,1494,1,,2422
34.74,3938,1,,,34.74,1468,1,,2470
34.76,3994,1,,,34.76,1432,1,,2562
34.78,3987,1,,,34.78,1513,1,,2474
34.8,4063,1,,,34.8,1429,1,,2634
34.82,3882,1,,,34.82,1407,1,,2475
34.84,3834,1,,,34.84,1425,1,,2409
34.86,3876,1,,,34.86,1491,1,,2385
34.88,3913,1,,,34.88,1464,1,,2449
34.9,3900,1,,,34.9,1456,1,,2444
34.92,3939,1,,,34.92,1445,1,,2494
34.94,3900,1,,,34.94,1463,1,,2437
34.96,3974,1,,,34.96,1469,1,,2505
34.98,3930,1,,,34.98,1452,1,,2478
35,3940,1,,,35,1403,1,,2537
35.02,3958,1,,,35.02,1492,1,,2466
35.04,3948,1,,,35.04,1375,1,,2573
35.06,3942,1,,,35.06,1458,1,,2484
35.08,3961,1,,,35.08,1404,1,,2557
35.1,3856,1,,,35.1,1420,1,,2436
35.12,3897,1,,,35.12,1325,1,,2572
35.14,4016,1,,,35.14,1371,1,,2645
35.16,3966,1,,,35.16,1393,1,,2573
35.18,3943,1,,,35.18,1337,1,,2606
35.2,4033,1,,,35.2,1400,1,,2633
35.22,4065,1,,,35.22,1394,1,,2671
35.24,4058,1,,,35.24,1387,1,,2671
35.26,4070,1,,,35.26,1368,1,,2702
35.28,4094,1,,,35.28,1377,1,,2717
35.3,4231,1,,,35.3,1357,1,,2874
35.32,4282,1,,,35.32,1433,1,,2849
35.34,4273,1,,,35.34,1398,1,,2875
35.36,4362,1,,,35.36,1350,1,,3012
35.38,4382,1,,,35.38,1327,1,,3055
35.4,4427,1,,,35.4,1384,1,,3043
35.42,4434,1,,,35.42,1443,1,,2991
35.44,4428,1,,,35.44,1347,1,,3081
35.46,4592,1,,,35.46,1390,1,,3202
35.48,4386,1,,,35.48,1342,1,,3044
35.5,4341,1,,,35.5,1378,1,,2963
35.52,4266,1,,,35.52,1411,1,,2855
35.54,4254,1,,,35.54,1386,1,,2868
35.56,4209,1,,,35.56,1392,1,,2817
35.58,4228,1,,,35.58,1367,1,,2861
35.6,4172,1,,,35.6,1373,1,,2799
35.62,4206,1,,,35.62,1326,1,,2880
35.64,4227,1,,,35.64,1362,1,,2865
35.66,4185,1,,,35.66,1349,1,,2836
35.68,4201,1,,,35.68,1305,1,,2896
35.7,4179,1,,,35.7,1285,1,,2894
35.72,4145,1,,,35.72,1307,1,,2838
35.74,4444,1,,,35.74,1332,1,,3112
35.76,4373,1,,,35.76,1381,1,,2992
35.78,4416,1,,,35.78,1301,1,,3115
35.8,4362,1,,,35.8,1339,1,,3023
35.82,4496,1,,,35.82,1269,1,,3227
35.84,4374,1,,,35.84,1270,1,,3104
35.86,4348,1,,,35.86,1333,1,,3015
35.88,4431,1,,,35.88,1308,1,,3123
35.9,4449,1,,,35.9,1333,1,,3116
35.92,4440,1,,,35.92,1292,1,,3148
35.94,4351,1,,,35.94,1276,1,,3075
35.96,4371,1,,,35.96,1309,1,,3062
35.98,4216,1,,,35.98,1270,1,,2946
36,4267,1,,,36,1249,1,,3018
36.02,4252,1,,,36.02,1311,1,,2941
36.04,4184,1,,,36.04,1258,1,,2926
36.06,4069,1,,,36.06,1235,1,,2834
36.08,3948,1,,,36.08,1320,1,,2628
36.1,4045,1,,,36.1,1314,1,,2731
36.12,3905,1,,,36.12,1358,1,,2547
36.14,4045,1,,,36.14,1240,1,,2805
36.16,4024,1,,,36.16,1276,1,,2748
36.18,3937,1,,,36.18,1288,1,,2649
36.2,3928,1,,,36.2,1239,1,,2689
36.22,3967,1,,,36.22,1274,1,,2693
36.24,3830,1,,,36.24,1319,1,,2511
36.26,3883,1,,,36.26,1335,1,,2548
36.28,3976,1,,,36.28,1317,1,,2659
36.3,3889,1,,,36.3,1307,1,,2582
36.32,3893,1,,,36.32,1298,1,,2595
36.34,4004,1,,,36.34,1261,1,,2743
36.36,3943,1,,,36.36,1271,1,,2672
36.38,3810,1,,,36.38,1253,1,,2557
36.4,3924,1,,,36.4,1247,1,,2677
36.42,3874,1,,,36.42,1246,1,,2628
36.44,3896,1,,,36.44,1254,1,,2642
36.46,3942,1,,,36.46,1191,1,,2751
36.48,3931,1,,,36.48,1195,1,,2736
36.5,3838,1,,,36.5,1240,1,,2598
36.52,3846,1,,,36.52,1235,1,,2611
36.54,3847,1,,,36.54,1256,1,,2591
36.56,3785,1,,,36.56,1192,1,,2593
36.58,3831,1,,,36.58,1209,1,,2622
36.6,3836,1,,,36.6,1282,1,,2554
36.62,3929,1,,,36.62,1233,1,,2696
36.64,3808,1,,,36.64,1204,1,,2604
36.66,3794,1,,,36.66,1229,1,,2565
36.68,3859,1,,,36.68,1225,1,,2634
36.7,3920,1,,,36.7,1252,1,,2668
36.72,3972,1,,,36.72,1176,1,,2796
36.74,3890,1,,,36.74,1241,1,,2649
36.76,3968,1,,,36.76,1253,1,,2715
36.78,3838,1,,,36.78,1214,1,,2624
36.8,3884,1,,,36.8,1174,1,,2710
36.82,3920,1,,,36.82,1169,1,,2751
36.84,4033,1,,,36.84,1214,1,,2819
36.86,3976,1,,,36.86,1215,1,,2761
36.88,4027,1,,,36.88,1193,1,,2834
36.9,3901,1,,,36.9,1153,1,,2748
36.92,3932,1,,,36.92,1184,1,,2748
36.94,3939,1,,,36.94,1253,1,,2686
36.96,3909,1,,,36.96,1237,1,,2672
36.98,3985,1,,,36.98,1200,1,,2785
37,4106,1,,,37,1140,1,,2966
37.02,4041,1,,,37.02,1167,1,,2874
37.04,4082,1,,,37.04,1255,1,,2827
37.06,4006,1,,,37.06,1156,1,,2850
37.08,4004,1,,,37.08,1133,1,,2871
37.1,4113,1,,,37.1,1176,1,,2937
37.12,4037,1,,,37.12,1170,1,,2867
37.14,4027,1,,,37.14,1179,1,,2848
37.16,4097,1,,,37.16,1160,1,,2937
37.18,4162,1,,,37.18,1174,1,,2988
37.2,4165,1,,,37.2,1218,1,,2947
37.22,4252,1,,,37.22,1155,1,,3097
37.24,4201,1,,,37.24,1149,1,,3052
37.26,4190,1,,,37.26,1197,1,,2993
37.28,4182,1,,,37.28,1184,1,,2998
37.3,4327,1,,,37.3,1199,1,,3128
37.32,4344,1,,,37.32,1186,1,,3158
37.34,4480,1,,,37.34,1163,1,,3317
37.36,4387,1,,,37.36,1195,1,,3192
37.38,4337,1,,,37.38,1178,1,,3159
37.4,4389,1,,,37.4,1183,1,,3206
37.42,4422,1,,,37.42,1168,1,,3254
37.44,4457,1,,,37.44,1191,1,,3266
37.46,4473,1,,,37.46,1151,1,,3322
37.48,4455,1,,,37.48,1165,1,,3290
37.5,4460,1,,,37.5,1212,1,,3248
37.52,4609,1,,,37.52,1160,1,,3449
37.54,4594,1,,,37.54,1160,1,,3434
37.56,4745,1,,,37.56,1156,1,,3589
37.58,4822,1,,,37.58,1118,1,,3704
37.6,4802,1,,,37.6,1146,1,,3656
37.62,4827,1,,,37.62,1180,1,,3647
37.64,4968,1,,,37.64,1225,1,,3743
37.66,4982,1,,,37.66,1180,1,,3802
37.68,5068,1,,,37.68,1147,1,,3921
37.7,5089,1,,,37.7,1175,1,,3914
37.72,5318,1,,,37.72,1217,1,,4101
37.74,5486,1,,,37.74,1114,1,,4372
37.76,5525,1,,,37.76,1133,1,,4392
37.78,5631,1,,,37.78,1130,1,,4501
37.8,5922,1,,,37.8,1176,1,,4746
37.82,5917,1,,,37.82,1172,1,,4745
37.84,6208,1,,,37.84,1130,1,,5078
37.86,6545,1,,,37.86,1120,1,,5425
37.88,6752,1,,,37.88,1078,1,,5674
37.9,7142,1,,,37.9,1093,1,,6049
37.92,7310,1,,,37.92,1141,1,,6169
37.94,7492,1,,,37.94,1168,1,,6324
37.96,7847,1,,,37.96,1119,1,,6728
37.98,8150,1,,,37.98,1087,1,,7063
38,8302,1,,,38,1091,1,,7211
38.02,8445,1,,,38.02,1091,1,,7354
38.04,8686,1,,,38.04,1172,1,,7514
38.06,8847,1,,,38.06,1110,1,,7737
38.08,8826,1,,,38.08,1141,1,,7685
38.1,8649,1,,,38.1,1135,1,,7514
38.12,8415,1,,,38.12,1093,1,,7322
38.14,8260,1,,,38.14,1088,1,,7172
38.16,8161,1,,,38.16,1090,1,,7071
38.18,7848,1,,,38.18,1093,1,,6755
38.2,7743,1,,,38.2,1077,1,,6666
38.22,7504,1,,,38.22,1134,1,,6370
38.24,7041,1,,,38.24,1139,1,,5902
38.26,6831,1,,,38.26,1105,1,,5726
38.28,6520,1,,,38.28,1113,1,,5407
38.3,6550,1,,,38.3,1147,1,,5403
38.32,6107,1,,,38.32,1112,1,,4995
38.34,6012,1,,,38.34,1070,1,,4942
38.36,5967,1,,,38.36,1111,1,,4856
38.38,5845,1,,,38.38,1058,1,,4787
38.4,5766,1,,,38.4,1063,1,,4703
38.42,5844,1,,,38.42,1146,1,,4698
38.44,5622,1,,,38.44,1155,1,,4467
38.46,5622,1,,,38.46,1145,1,,4477
38.48,5488,1,,,38.48,1086,1,,4402
38.5,5408,1,,,38.5,1065,1,,4343
38.52,5357,1,,,38.52,1091,1,,4266
38.54,5230,1,,,38.54,1113,1,,4117
38.56,5193,1,,,38.56,1076,1,,4117
38.58,5185,1,,,38.58,1087,1,,4098
38.6,4948,1,,,38.6,1052,1,,3896
38.62,4936,1,,,38.62,1108,1,,3828
38.64,4669,1,,,38.64,1105,1,,3564
38.66,4718,1,,,38.66,1115,1,,3603
38.68,4702,1,,,38.68,1091,1,,3611
38.7,4666,1,,,38.7,1058,1,,3608
38.72,4646,1,,,38.72,1062,1,,3584
38.74,4543,1,,,38.74,1066,1,,3477
38.76,4387,1,,,38.76,1099,1,,3288
38.78,4441,1,,,38.78,1019,1,,3422
38.8,4444,1,,,38.8,1012,1,,3432
38.82,4458,1,,,38.82,1012,1,,3446
38.84,4474,1,,,38.84,1100,1,,3374
38.86,4503,1,,,38.86,1099,1,,3404
38.88,4617,1,,,38.88,1072,1,,3545
38.9,4541,1,,,38.9,1046,1,,3495
38.92,4603,1,,,38.92,1033,1,,3570
38.94,4752,1,,,38.94,1081,1,,3671
38.96,4682,1,,,38.96,1111,1,,3571
38.98,4675,1,,,38.98,1054,1,,3621
39,4581,1,,,39,1049,1,,3532
39.02,4543,1,,,39.02,1056,1,,3487
39.04,4512,1,,,39.04,1077,1,,3435
39.06,4529,1,,,39.06,1087,1,,3442
39.08,4469,1,,,39.08,1050,1,,3419
39.1,4401,1,,,39.1,1089,1,,3312
39.12,4433,1,,,39.12,1083,1,,3350
39.14,4289,1,,,39.14,1056,1,,3233
39.16,4212,1,,,39.16,1077,1,,3135
39.18,4193,1,,,39.18,1032,1,,3161
39.2,4107,1,,,39.2,1037,1,,3070
39.22,4064,1,,,39.22,1043,1,,3021
39.24,3972,1,,,39.24,1076,1,,2896
39.26,3948,1,,,39.26,1122,1,,2826
39.28,3992,1,,,39.28,1130,1,,2862
39.3,4030,1,,,39.3,1075,1,,2955
39.32,3931,1,,,39.32,1037,1,,2894
39.34,3916,1,,,39.34,1072,1,,2844
39.36,3889,1,,,39.36,1072,1,,2817
39.38,3857,1,,,39.38,1074,1,,2783
39.4,3816,1,,,39.4,1060,1,,2756
39.42,3909,1,,,39.42,1063,1,,2846
39.44,3867,1,,,39.44,1070,1,,2797
39.46,3793,1,,,39.46,1044,1,,2749
39.48,3796,1,,,39.48,1048,1,,2748
39.5,3802,1,,,39.5,1078,1,,2724
39.52,3807,1,,,39.52,1044,1,,2763
39.54,3688,1,,,39.54,1042,1,,2646
39.56,3865,1,,,39.56,1063,1,,2802
39.58,3621,1,,,39.58,1038,1,,2583
39.6,3721,1,,,39.6,1024,1,,2697
39.62,3771,1,,,39.62,1041,1,,2730
39.64,3777,1,,,39.64,1003,1,,2774
39.66,3751,1,,,39.66,1035,1,,2716
39.68,3666,1,,,39.68,1070,1,,2596
39.7,3665,1,,,39.7,1043,1,,2622
39.72,3730,1,,,39.72,1098,1,,2632
39.74,3639,1,,,39.74,1083,1,,2556
39.76,3668,1,,,39.76,1099,1,,2569
39.78,3702,1,,,39.78,1041,1,,2661
39.8,3677,1,,,39.8,1069,1,,2608
39.82,3581,1,,,39.82,1047,1,,2534
39.84,3528,1,,,39.84,1065,1,,2463
39.86,3643,1,,,39.86,1012,1,,2631
39.88,3643,1,,,39.88,1064,1,,2579
39.9,3631,1,,,39.9,1052,1,,2579
39.92,3488,1,,,39.92,1059,1,,2429
39.94,3486,1,,,39.94,1019,1,,2467
39.96,3430,1,,,39.96,1037,1,,2393
39.98,3432,1,,,39.98,1006,1,,2426
40,3548,1,,,40,1026,1,,2522
40.02,3481,1,,,40.02,1003,1,,2478
40.04,3497,1,,,40.04,1053,1,,2444
40.06,3513,1,,,40.06,1013,1,,2500
40.08,3606,1,,,40.08,1077,1,,2529
40.1,3460,1,,,40.1,1056,1,,2404
40.12,3537,1,,,40.12,1106,1,,2431
40.14,3548,1,,,40.14,1075,1,,2473
40.16,3518,1,,,40.16,1068,1,,2450
40.18,3592,1,,,40.18,1072,1,,2520
40.2,3671,1,,,40.2,1014,1,,2657
40.22,3623,1,,,40.22,1063,1,,2560
40.24,3604,1,,,40.24,1068,1,,2536
40.26,3545,1,,,40.26,1048,1,,2497
40.28,3548,1,,,40.28,1028,1,,2520
40.3,3432,1,,,40.3,1056,1,,2376
40.32,3506,1,,,40.32,1010,1,,2496
40.34,3452,1,,,40.34,1013,1,,2439
40.36,3532,1,,,40.36,1007,1,,2525
40.38,3495,1,,,40.38,992,1,,2503
40.4,3568,1,,,40.4,1051,1,,2517
40.42,3611,1,,,40.42,1029,1,,2582
40.44,3427,1,,,40.44,1040,1,,2387
40.46,3345,1,,,40.46,1014,1,,2331
40.48,3439,1,,,40.48,1023,1,,2416
40.5,3373,1,,,40.5,1040,1,,2333
40.52,3401,1,,,40.52,1061,1,,2340
40.54,3414,1,,,40.54,1041,1,,2373
40.56,3531,1,,,40.56,1048,1,,2483
40.58,3466,1,,,40.58,1063,1,,2403
40.6,3500,1,,,40.6,1070,1,,2430
40.62,3561,1,,,40.62,1040,1,,2521
40.64,3477,1,,,40.64,1040,1,,2437
40.66,3428,1,,,40.66,1070,1,,2358
40.68,3446,1,,,40.68,1048,1,,2398
40.7,3367,1,,,40.7,1034,1,,2333
40.72,3404,1,,,40.72,1019,1,,2385
40.74,3374,1,,,40.74,1014,1,,2360
40.76,3498,1,,,40.76,1068,1,,2430
40.78,3467,1,,,40.78,1043,1,,2424
40.8,3473,1,,,40.8,1032,1,,2441
40.82,3468,1,,,40.82,1029,1,,2439
40.84,3372,1,,,40.84,1011,1,,2361
40.86,3508,1,,,40.86,1059,1,,2449
40.88,3492,1,,,40.88,1023,1,,2469
40.9,3509,1,,,40.9,1077,1,,2432
40.92,3419,1,,,40.92,1042,1,,2377
40.94,3400,1,,,40.94,1038,1,,2362
40.96,3397,1,,,40.96,1058,1,,2339
40.98,3503,1,,,40.98,1041,1,,2462
41,3459,1,,,41,1030,1,,2429
41.02,3414,1,,,41.02,1021,1,,2393
41.04,3398,1,,,41.04,1067,1,,2331
41.06,3416,1,,,41.06,1036,1,,2380
41.08,3387,1,,,41.08,1045,1,,2342
41.1,3341,1,,,41.1,1055,1,,2286
41.12,3376,1,,,41.12,999,1,,2377
41.14,3291,1,,,41.14,1033,1,,2258
41.16,3359,1,,,41.16,1013,1,,2346
41.18,3380,1,,,41.18,1031,1,,2349
41.2,3414,1,,,41.2,1038,1,,2376
41.22,3386,1,,,41.22,1049,1,,2337
41.24,3329,1,,,41.24,1039,1,,2290
41.26,3359,1,,,41.26,1037,1,,2322
41.28,3396,1,,,41.28,1009,1,,2387
41.3,3378,1,,,41.3,1041,1,,2337
41.32,3406,1,,,41.32,1088,1,,2318
41.34,3421,1,,,41.34,1066,1,,2355
41.36,3358,1,,,41.36,1078,1,,2280
41.38,3429,1,,,41.38,1020,1,,2409
41.4,3461,1,,,41.4,1048,1,,2413
41.42,3448,1,,,41.42,1095,1,,2353
41.44,3402,1,,,41.44,1080,1,,2322
41.46,3460,1,,,41.46,999,1,,2461
41.48,3470,1,,,41.48,980,1,,2490
41.5,3502,1,,,41.5,1012,1,,2490
41.52,3700,1,,,41.52,1028,1,,2672
41.54,3690,1,,,41.54,1052,1,,2638
41.56,3622,1,,,41.56,1041,1,,2581
41.58,3640,1,,,41.58,1007,1,,2633
41.6,3655,1,,,41.6,1077,1,,2578
41.62,3560,1,,,41.62,1040,1,,2520
41.64,3685,1,,,41.64,1039,1,,2646
41.66,3605,1,,,41.66,1085,1,,2520
41.68,3682,1,,,41.68,979,1,,2703
41.7,3592,1,,,41.7,1069,1,,2523
41.72,3492,1,,,41.72,1055,1,,2437
41.74,3566,1,,,41.74,1021,1,,2545
41.76,3493,1,,,41.76,1062,1,,2431
41.78,3528,1,,,41.78,1075,1,,2453
41.8,3424,1,,,41.8,1021,1,,2403
41.82,3447,1,,,41.82,1009,1,,2438
41.84,3494,1,,,41.84,1057,1,,2437
41.86,3448,1,,,41.86,1026,1,,2422
41.88,3464,1,,,41.88,982,1,,2482
41.9,3461,1,,,41.9,1075,1,,2386
41.92,3413,1,,,41.92,1021,1,,2392
41.94,3365,1,,,41.94,1058,1,,2307
41.96,3424,1,,,41.96,1051,1,,2373
41.98,3455,1,,,41.98,1061,1,,2394
42,3446,1,,,42,1035,1,,2411
42.02,3560,1,,,42.02,1065,1,,2495
42.04,3551,1,,,42.04,1007,1,,2544
42.06,3486,1,,,42.06,1062,1,,2424
42.08,3492,1,,,42.08,1038,1,,2454
42.1,3621,1,,,42.1,1081,1,,2540
42.12,3655,1,,,42.12,1039,1,,2616
42.14,3557,1,,,42.14,1045,1,,2512
42.16,3584,1,,,42.16,1008,1,,2576
42.18,3472,1,,,42.18,1001,1,,2471
42.2,3609,1,,,42.2,1011,1,,2598
42.22,3506,1,,,42.22,995,1,,2511
42.24,3501,1,,,42.24,1004,1,,2497
42.26,3607,1,,,42.26,1027,1,,2580
42.28,3457,1,,,42.28,1039,1,,2418
42.3,3472,1,,,42.3,1059,1,,2413
42.32,3386,1,,,42.32,1030,1,,2356
42.34,3385,1,,,42.34,994,1,,2391
42.36,3423,1,,,42.36,1011,1,,2412
42.38,3304,1,,,42.38,1034,1,,2270
42.4,3334,1,,,42.4,1055,1,,2279
42.42,3347,1,,,42.42,973,1,,2374
42.44,3286,1,,,42.44,1018,1,,2268
42.46,3348,1,,,42.46,1098,1,,2250
42.48,3320,1,,,42.48,1070,1,,2250
42.5,3417,1,,,42.5,1050,1,,2367
42.52,3325,1,,,42.52,1043,1,,2282
42.54,3375,1,,,42.54,1043,1,,2332
42.56,3342,1,,,42.56,982,1,,2360
42.58,3385,1,,,42.58,970,1,,2415
42.6,3283,1,,,42.6,1028,1,,2255
42.62,3254,1,,,42.62,1060,1,,2194
42.64,3386,1,,,42.64,1066,1,,2320
42.66,3348,1,,,42.66,1091,1,,2257
42.68,3341,1,,,42.68,1071,1,,2270
42.7,3347,1,,,42.7,1039,1,,2308
42.72,3379,1,,,42.72,1053,1,,2326
42.74,3293,1,,,42.74,1010,1,,2283
42.76,3197,1,,,42.76,1036,1,,2161
42.78,3218,1,,,42.78,1020,1,,2198
42.8,3354,1,,,42.8,1034,1,,2320
42.82,3352,1,,,42.82,999,1,,2353
42.84,3382,1,,,42.84,1008,1,,2374
42.86,3305,1,,,42.86,1016,1,,2289
42.88,3379,1,,,42.88,1042,1,,2337
42.9,3298,1,,,42.9,988,1,,2310
42.92,3314,1,,,42.92,1008,1,,2306
42.94,3297,1,,,42.94,1009,1,,2288
42.96,3252,1,,,42.96,1006,1,,2246
42.98,3289,1,,,42.98,1003,1,,2286
43,3359,1,,,43,1056,1,,2303
43.02,3377,1,,,43.02,1003,1,,2374
43.04,3325,1,,,43.04,1004,1,,2321
43.06,3434,1,,,43.06,987,1,,2447
43.08,3266,1,,,43.08,1024,1,,2242
43.1,3370,1,,,43.1,1028,1,,2342
43.12,3270,1,,,43.12,977,1,,2293
43.14,3312,1,,,43.14,1015,1,,2297
43.16,3359,1,,,43.16,1016,1,,2343
43.18,3409,1,,,43.18,1036,1,,2373
43.2,3282,1,,,43.2,980,1,,2302
43.22,3396,1,,,43.22,934,1,,2462
43.24,3347,1,,,43.24,1010,1,,2337
43.26,3346,1,,,43.26,1049,1,,2297
43.28,3346,1,,,43.28,998,1,,2348
43.3,3361,1,,,43.3,1032,1,,2329
43.32,3448,1,,,43.32,1006,1,,2442
43.34,3344,1,,,43.34,978,1,,2366
43.36,3373,1,,,43.36,1032,1,,2341
43.38,3375,1,,,43.38,1058,1,,2317
43.4,3398,1,,,43.4,1046,1,,2352
43.42,3354,1,,,43.42,995,1,,2359
43.44,3397,1,,,43.44,988,1,,2409
43.46,3305,1,,,43.46,960,1,,2345
43.48,3352,1,,,43.48,1018,1,,2334
43.5,3471,1,,,43.5,971,1,,2500
43.52,3460,1,,,43.52,1033,1,,2427
43.54,3366,1,,,43.54,977,1,,2389
43.56,3449,1,,,43.56,990,1,,2459
43.58,3479,1,,,43.58,1010,1,,2469
43.6,3426,1,,,43.6,1004,1,,2422
43.62,3428,1,,,43.62,984,1,,2444
43.64,3454,1,,,43.64,1007,1,,2447
43.66,3420,1,,,43.66,1008,1,,2412
43.68,3469,1,,,43.68,1002,1,,2467
43.7,3443,1,,,43.7,1070,1,,2373
43.72,3535,1,,,43.72,1032,1,,2503
43.74,3533,1,,,43.74,989,1,,2544
43.76,3571,1,,,43.76,972,1,,2599
43.78,3574,1,,,43.78,1003,1,,2571
43.8,3531,1,,,43.8,969,1,,2562
43.82,3585,1,,,43.82,983,1,,2602
43.84,3602,1,,,43.84,989,1,,2613
43.86,3610,1,,,43.86,1022,1,,2588
43.88,3636,1,,,43.88,1032,1,,2604
43.9,3714,1,,,43.9,991,1,,2723
43.92,3702,1,,,43.92,995,1,,2707
43.94,3711,1,,,43.94,992,1,,2719
43.96,3601,1,,,43.96,1017,1,,2584
43.98,3797,1,,,43.98,982,1,,2815
44,3792,1,,,44,1004,1,,2788
44.02,3800,1,,,44.02,951,1,,2849
44.04,3953,1,,,44.04,1001,1,,2952
44.06,3954,1,,,44.06,962,1,,2992
44.08,3986,1,,,44.08,1011,1,,2975
44.1,4042,1,,,44.1,972,1,,3070
44.12,4051,1,,,44.12,973,1,,3078
44.14,4087,1,,,44.14,953,1,,3134
44.16,4060,1,,,44.16,1018,1,,3042
44.18,4047,1,,,44.18,987,1,,3060
44.2,4142,1,,,44.2,1028,1,,3114
44.22,4091,1,,,44.22,1001,1,,3090
44.24,4049,1,,,44.24,1057,1,,2992
44.26,4056,1,,,44.26,1007,1,,3049
44.28,4119,1,,,44.28,1041,1,,3078
44.3,4228,1,,,44.3,981,1,,3247
44.32,4117,1,,,44.32,997,1,,3120
44.34,4082,1,,,44.34,965,1,,3117
44.36,3985,1,,,44.36,976,1,,3009
44.38,4042,1,,,44.38,997,1,,3045
44.4,4004,1,,,44.4,970,1,,3034
44.42,3897,1,,,44.42,1011,1,,2886
44.44,3942,1,,,44.44,958,1,,2984
44.46,3833,1,,,44.46,946,1,,2887
44.48,3861,1,,,44.48,932,1,,2929
44.5,3734,1,,,44.5,998,1,,2736
44.52,3710,1,,,44.52,989,1,,2721
44.54,3808,1,,,44.54,977,1,,2831
44.56,3737,1,,,44.56,975,1,,2762
44.58,3694,1,,,44.58,997,1,,2697
44.6,3756,1,,,44.6,940,1,,2816
44.62,3655,1,,,44.62,960,1,,2695
44.64,3696,1,,,44.64,928,1,,2768
44.66,3730,1,,,44.66,957,1,,2773
44.68,3674,1,,,44.68,950,1,,2724
44.7,3728,1,,,44.7,929,1,,2799
44.72,3727,1,,,44.72,983,1,,2744
44.74,3735,1,,,44.74,999,1,,2736
44.76,3573,1,,,44.76,975,1,,2598
44.78,3606,1,,,44.78,954,1,,2652
44.8,3512,1,,,44.8,960,1,,2552
44.82,3509,1,,,44.82,1022,1,,2487
44.84,3511,1,,,44.84,984,1,,2527
44.86,3486,1,,,44.86,1001,1,,2485
44.88,3364,1,,,44.88,979,1,,2385
44.9,3338,1,,,44.9,1004,1,,2334
44.92,3273,1,,,44.92,922,1,,2351
44.94,3312,1,,,44.94,960,1,,2352
44.96,3279,1,,,44.96,972,1,,2307
44.98,3236,1,,,44.98,955,1,,2281
45,3197,1,,,45,945,1,,2252
45.02,3248,1,,,45.02,951,1,,2297
45.04,3235,1,,,45.04,941,1,,2294
45.06,3157,1,,,45.06,953,1,,2204
45.08,3179,1,,,45.08,964,1,,2215
45.1,3245,1,,,45.1,987,1,,2258
45.12,3120,1,,,45.12,995,1,,2125
45.14,3184,1,,,45.14,985,1,,2199
45.16,3204,1,,,45.16,981,1,,2223
45.18,3179,1,,,45.18,962,1,,2217
45.2,3168,1,,,45.2,960,1,,2208
45.22,3169,1,,,45.22,970,1,,2199
45.24,3182,1,,,45.24,960,1,,2222
45.26,3154,1,,,45.26,1030,1,,2124
45.28,3182,1,,,45.28,983,1,,2199
45.3,3292,1,,,45.3,987,1,,2305
45.32,3237,1,,,45.32,996,1,,2241
45.34,3149,1,,,45.34,957,1,,2192
45.36,3163,1,,,45.36,970,1,,2193
45.38,3125,1,,,45.38,957,1,,2168
45.4,3206,1,,,45.4,989,1,,2217
45.42,3148,1,,,45.42,951,1,,2197
45.44,3179,1,,,45.44,976,1,,2203
45.46,3057,1,,,45.46,962,1,,2095
45.48,3053,1,,,45.48,990,1,,2063
45.5,3111,1,,,45.5,990,1,,2121
45.52,3089,1,,,45.52,956,1,,2133
45.54,2985,1,,,45.54,919,1,,2066
45.56,2978,1,,,45.56,954,1,,2024
45.58,2980,1,,,45.58,939,1,,2041
45.6,2983,1,,,45.6,938,1,,2045
45.62,2960,1,,,45.62,958,1,,2002
45.64,3102,1,,,45.64,934,1,,2168
45.66,3035,1,,,45.66,939,1,,2096
45.68,2900,1,,,45.68,901,1,,1999
45.7,2911,1,,,45.7,927,1,,1984
45.72,2955,1,,,45.72,967,1,,1988
45.74,2986,1,,,45.74,1003,1,,1983
45.76,2873,1,,,45.76,939,1,,1934
45.78,2908,1,,,45.78,935,1,,1973
45.8,2865,1,,,45.8,914,1,,1951
45.82,2960,1,,,45.82,915,1,,2045
45.84,2922,1,,,45.84,960,1,,1962
45.86,2873,1,,,45.86,924,1,,1949
45.88,2852,1,,,45.88,966,1,,1886
45.9,2874,1,,,45.9,917,1,,1957
45.92,2899,1,,,45.92,948,1,,1951
45.94,2856,1,,,45.94,895,1,,1961
45.96,2854,1,,,45.96,972,1,,1882
45.98,2856,1,,,45.98,928,1,,1928
46,2807,1,,,46,959,1,,1848
46.02,2771,1,,,46.02,924,1,,1847
46.04,2795,1,,,46.04,955,1,,1840
46.06,2960,1,,,46.06,1022,1,,1938
46.08,2803,1,,,46.08,999,1,,1804
46.1,2769,1,,,46.1,904,1,,1865
46.12,2806,1,,,46.12,916,1,,1890
46.14,2759,1,,,46.14,952,1,,1807
46.16,2816,1,,,46.16,945,1,,1871
46.18,2898,1,,,46.18,913,1,,1985
46.2,2874,1,,,46.2,877,1,,1997
46.22,2819,1,,,46.22,921,1,,1898
46.24,2823,1,,,46.24,973,1,,1850
46.26,2810,1,,,46.26,955,1,,1855
46.28,2842,1,,,46.28,886,1,,1956
46.3,2736,1,,,46.3,929,1,,1807
46.32,2808,1,,,46.32,900,1,,1908
46.34,2824,1,,,46.34,899,1,,1925
46.36,2834,1,,,46.36,914,1,,1920
46.38,2793,1,,,46.38,876,1,,1917
46.4,2817,1,,,46.4,932,1,,1885
46.42,2827,1,,,46.42,947,1,,1880
46.44,2779,1,,,46.44,973,1,,1806
46.46,2817,1,,,46.46,880,1,,1937
46.48,2732,1,,,46.48,978,1,,1754
46.5,2825,1,,,46.5,925,1,,1900
46.52,2817,1,,,46.52,911,1,,1906
46.54,2814,1,,,46.54,889,1,,1925
46.56,2745,1,,,46.56,879,1,,1866
46.58,2765,1,,,46.58,933,1,,1832
46.6,2684,1,,,46.6,959,1,,1725
46.62,2738,1,,,46.62,869,1,,1869
46.64,2685,1,,,46.64,921,1,,1764
46.66,2774,1,,,46.66,916,1,,1858
46.68,2714,1,,,46.68,906,1,,1808
46.7,2683,1,,,46.7,900,1,,1783
46.72,2838,1,,,46.72,930,1,,1908
46.74,2829,1,,,46.74,909,1,,1920
46.76,2772,1,,,46.76,904,1,,1868
46.78,2751,1,,,46.78,924,1,,1827
46.8,2711,1,,,46.8,944,1,,1767
46.82,2795,1,,,46.82,936,1,,1859
46.84,2700,1,,,46.84,917,1,,1783
46.86,2702,1,,,46.86,950,1,,1752
46.88,2756,1,,,46.88,980,1,,1776
46.9,2714,1,,,46.9,908,1,,1806
46.92,2658,1,,,46.92,889,1,,1769
46.94,2721,1,,,46.94,874,1,,1847
46.96,2717,1,,,46.96,927,1,,1790
46.98,2638,1,,,46.98,931,1,,1707
47,2671,1,,,47,890,1,,1781
47.02,2744,1,,,47.02,937,1,,1807
47.04,2686,1,,,47.04,923,1,,1763
47.06,2717,1,,,47.06,892,1,,1825
47.08,2782,1,,,47.08,919,1,,1863
47.1,2768,1,,,47.1,890,1,,1878
47.12,2692,1,,,47.12,931,1,,1761
47.14,2706,1,,,47.14,914,1,,1792
47.16,2680,1,,,47.16,922,1,,1758
47.18,2686,1,,,47.18,974,1,,1712
47.2,2748,1,,,47.2,922,1,,1826
47.22,2667,1,,,47.22,915,1,,1752
47.24,2697,1,,,47.24,875,1,,1822
47.26,2649,1,,,47.26,911,1,,1738
47.28,2706,1,,,47.28,915,1,,1791
47.3,2718,1,,,47.3,927,1,,1791
47.32,2577,1,,,47.32,924,1,,1653
47.34,2687,1,,,47.34,856,1,,1831
47.36,2643,1,,,47.36,886,1,,1757
47.38,2681,1,,,47.38,948,1,,1733
47.4,2736,1,,,47.4,927,1,,1809
47.42,2692,1,,,47.42,898,1,,1794
47.44,2750,1,,,47.44,928,1,,1822
47.46,2623,1,,,47.46,911,1,,1712
47.48,2695,1,,,47.48,962,1,,1733
47.5,2639,1,,,47.5,930,1,,1709
47.52,2680,1,,,47.52,908,1,,1772
47.54,2703,1,,,47.54,895,1,,1808
47.56,2675,1,,,47.56,890,1,,1785
47.58,2704,1,,,47.58,895,1,,1809
47.6,2625,1,,,47.6,897,1,,1728
47.62,2696,1,,,47.62,881,1,,1815
47.64,2732,1,,,47.64,896,1,,1836
47.66,2674,1,,,47.66,899,1,,1775
47.68,2711,1,,,47.68,911,1,,1800
47.7,2775,1,,,47.7,916,1,,1859
47.72,2757,1,,,47.72,917,1,,1840
47.74,2830,1,,,47.74,908,1,,1922
47.76,2780,1,,,47.76,922,1,,1858
47.78,2840,1,,,47.78,902,1,,1938
47.8,2807,1,,,47.8,847,1,,1960
47.82,2864,1,,,47.82,911,1,,1953
47.84,2833,1,,,47.84,882,1,,1951
47.86,2914,1,,,47.86,894,1,,2020
47.88,2892,1,,,47.88,896,1,,1996
47.9,2872,1,,,47.9,903,1,,1969
47.92,2882,1,,,47.92,881,1,,2001
47.94,2896,1,,,47.94,863,1,,2033
47.96,2877,1,,,47.96,909,1,,1968
47.98,2799,1,,,47.98,865,1,,1934
48,2847,1,,,48,873,1,,1974
48.02,2790,1,,,48.02,894,1,,1896
48.04,2824,1,,,48.04,905,1,,1919
48.06,2855,1,,,48.06,867,1,,1988
48.08,2761,1,,,48.08,862,1,,1899
48.1,2820,1,,,48.1,916,1,,1904
48.12,2681,1,,,48.12,821,1,,1860
48.14,2638,1,,,48.14,853,1,,1785
48.16,2724,1,,,48.16,910,1,,1814
48.18,2758,1,,,48.18,900,1,,1858
48.2,2637,1,,,48.2,856,1,,1781
48.22,2740,1,,,48.22,912,1,,1828
48.24,2662,1,,,48.24,934,1,,1728
48.26,2637,1,,,48.26,900,1,,1737
48.28,2698,1,,,48.28,870,1,,1828
48.3,2738,1,,,48.3,862,1,,1876
48.32,2660,1,,,48.32,915,1,,1745
48.34,2772,1,,,48.34,866,1,,1906
48.36,2657,1,,,48.36,852,1,,1805
48.38,2744,1,,,48.38,854,1,,1890
48.4,2736,1,,,48.4,907,1,,1829
48.42,2738,1,,,48.42,888,1,,1850
48.44,2786,1,,,48.44,859,1,,1927
48.46,2802,1,,,48.46,915,1,,1887
48.48,2760,1,,,48.48,910,1,,1850
48.5,2814,1,,,48.5,939,1,,1875
48.52,2857,1,,,48.52,880,1,,1977
48.54,2737,1,,,48.54,910,1,,1827
48.56,2712,1,,,48.56,906,1,,1806
48.58,2761,1,,,48.58,905,1,,1856
48.6,2838,1,,,48.6,878,1,,1960
48.62,2641,1,,,48.62,874,1,,1767
48.64,2685,1,,,48.64,853,1,,1832
48.66,2688,1,,,48.66,845,1,,1843
48.68,2560,1,,,48.68,901,1,,1659
48.7,2733,1,,,48.7,906,1,,1827
48.72,2676,1,,,48.72,906,1,,1770
48.74,2646,1,,,48.74,837,1,,1809
48.76,2629,1,,,48.76,886,1,,1743
48.78,2599,1,,,48.78,862,1,,1737
48.8,2610,1,,,48.8,849,1,,1761
48.82,2575,1,,,48.82,799,1,,1776
48.84,2617,1,,,48.84,858,1,,1759
48.86,2598,1,,,48.86,855,1,,1743
48.88,2559,1,,,48.88,849,1,,1710
48.9,2612,1,,,48.9,913,1,,1699
48.92,2634,1,,,48.92,858,1,,1776
48.94,2563,1,,,48.94,840,1,,1723
48.96,2541,1,,,48.96,874,1,,1667
48.98,2505,1,,,48.98,898,1,,1607
49,2572,1,,,49,925,1,,1647
49.02,2500,1,,,49.02,905,1,,1595
49.04,2523,1,,,49.04,865,1,,1658
49.06,2542,1,,,49.06,880,1,,1662
49.08,2613,1,,,49.08,846,1,,1767
49.1,2525,1,,,49.1,873,1,,1652
49.12,2581,1,,,49.12,883,1,,1698
49.14,2590,1,,,49.14,858,1,,1732
49.16,2475,1,,,49.16,882,1,,1593
49.18,2556,1,,,49.18,857,1,,1699
49.2,2502,1,,,49.2,872,1,,1630
49.22,2515,1,,,49.22,822,1,,1693
49.24,2527,1,,,49.24,849,1,,1678
49.26,2475,1,,,49.26,873,1,,1602
49.28,2514,1,,,49.28,851,1,,1663
49.3,2531,1,,,49.3,885,1,,1646
49.32,2575,1,,,49.32,829,1,,1746
49.34,2520,1,,,49.34,879,1,,1641
49.36,2457,1,,,49.36,881,1,,1576
49.38,2501,1,,,49.38,843,1,,1658
49.4,2501,1,,,49.4,861,1,,1640
49.42,2510,1,,,49.42,837,1,,1673
49.44,2544,1,,,49.44,905,1,,1639
49.46,2571,1,,,49.46,888,1,,1683
49.48,2482,1,,,49.48,880,1,,1602
49.5,2550,1,,,49.5,838,1,,1712
49.52,2517,1,,,49.52,897,1,,1620
49.54,2505,1,,,49.54,855,1,,1650
49.56,2519,1,,,49.56,884,1,,1635
49.58,2498,1,,,49.58,866,1,,1632
49.6,2532,1,,,49.6,835,1,,1697
49.62,2611,1,,,49.62,838,1,,1773
49.64,2531,1,,,49.64,852,1,,1679
49.66,2469,1,,,49.66,876,1,,1593
49.68,2577,1,,,49.68,852,1,,1725
49.7,2571,1,,,49.7,889,1,,1682
49.72,2432,1,,,49.72,835,1,,1597
49.74,2571,1,,,49.74,866,1,,1705
49.76,2532,1,,,49.76,783,1,,1749
49.78,2616,1,,,49.78,849,1,,1767
49.8,2607,1,,,49.8,883,1,,1724
49.82,2530,1,,,49.82,880,1,,1650
49.84,2553,1,,,49.84,878,1,,1675
49.86,2558,1,,,49.86,822,1,,1736
49.88,2510,1,,,49.88,866,1,,1644
49.9,2578,1,,,49.9,901,1,,1677
49.92,2576,1,,,49.92,841,1,,1735
49.94,2546,1,,,49.94,878,1,,1668
49.96,2560,1,,,49.96,832,1,,1728
49.98,2685,1,,,49.98,875,1,,1810
50,2615,1,,,50,859,1,,1756
50.02,2640,1,,,50.02,853,1,,1787
50.04,2574,1,,,50.04,865,1,,1709
50.06,2497,1,,,50.06,881,1,,1616
50.08,2537,1,,,50.08,857,1,,1680
50.1,2512,1,,,50.1,879,1,,1633
50.12,2469,1,,,50.12,828,1,,1641
50.14,2508,1,,,50.14,837,1,,1671
50.16,2507,1,,,50.16,826,1,,1681
50.18,2492,1,,,50.18,841,1,,1651
50.2,2528,1,,,50.2,847,1,,1681
50.22,2526,1,,,50.22,896,1,,1630
50.24,2568,1,,,50.24,857,1,,1711
50.26,2559,1,,,50.26,839,1,,1720
50.28,2519,1,,,50.28,873,1,,1646
50.3,2485,1,,,50.3,842,1,,1643
50.32,2488,1,,,50.32,854,1,,1634
50.34,2454,1,,,50.34,873,1,,1581
50.36,2510,1,,,50.36,817,1,,1693
50.38,2464,1,,,50.38,855,1,,1609
50.4,2592,1,,,50.4,798,1,,1794
50.42,2481,1,,,50.42,815,1,,1666
50.44,2488,1,,,50.44,838,1,,1650
50.46,2426,1,,,50.46,846,1,,1580
50.48,2422,1,,,50.48,880,1,,1542
50.5,2523,1,,,50.5,832,1,,1691
50.52,2423,1,,,50.52,826,1,,1597
50.54,2475,1,,,50.54,881,1,,1594
50.56,2379,1,,,50.56,849,1,,1530
50.58,2438,1,,,50.58,847,1,,1591
50.6,2383,1,,,50.6,873,1,,1510
50.62,2535,1,,,50.62,908,1,,1627
50.64,2429,1,,,50.64,856,1,,1573
50.66,2456,1,,,50.66,811,1,,1645
50.68,2552,1,,,50.68,817,1,,1735
50.7,2494,1,,,50.7,835,1,,1659
50.72,2488,1,,,50.72,874,1,,1614
50.74,2499,1,,,50.74,868,1,,1631
50.76,2502,1,,,50.76,862,1,,1640
50.78,2537,1,,,50.78,858,1,,1679
50.8,2483,1,,,50.8,800,1,,1683
50.82,2463,1,,,50.82,882,1,,1581
50.84,2476,1,,,50.84,859,1,,1617
50.86,2486,1,,,50.86,865,1,,1621
50.88,2520,1,,,50.88,800,1,,1720
50.9,2530,1,,,50.9,782,1,,1748
50.92,2524,1,,,50.92,812,1,,1712
50.94,2520,1,,,50.94,832,1,,1688
50.96,2506,1,,,50.96,847,1,,1659
50.98,2556,1,,,50.98,873,1,,1683
51,2551,1,,,51,839,1,,1712
51.02,2649,1,,,51.02,862,1,,1787
51.04,2597,1,,,51.04,782,1,,1815
51.06,2723,1,,,51.06,801,1,,1922
51.08,2687,1,,,51.08,822,1,,1865
51.1,2666,1,,,51.1,829,1,,1837
51.12,2590,1,,,51.12,842,1,,1748
51.14,2574,1,,,51.14,868,1,,1706
51.16,2630,1,,,51.16,823,1,,1807
51.18,2671,1,,,51.18,798,1,,1873
51.2,2597,1,,,51.2,882,1,,1715
51.22,2638,1,,,51.22,866,1,,1772
51.24,2631,1,,,51.24,881,1,,1750
51.26,2626,1,,,51.26,824,1,,1802
51.28,2631,1,,,51.28,851,1,,1780
51.3,2538,1,,,51.3,847,1,,1691
51.32,2527,1,,,51.32,815,1,,1712
51.34,2532,1,,,51.34,780,1,,1752
51.36,2564,1,,,51.36,862,1,,1702
51.38,2494,1,,,51.38,811,1,,1683
51.4,2464,1,,,51.4,814,1,,1650
51.42,2468,1,,,51.42,821,1,,1647
51.44,2498,1,,,51.44,834,1,,1664
51.46,2534,1,,,51.46,828,1,,1706
51.48,2591,1,,,51.48,830,1,,1761
51.5,2524,1,,,51.5,854,1,,1670
51.52,2544,1,,,51.52,843,1,,1701
51.54,2496,1,,,51.54,815,1,,1681
51.56,2588,1,,,51.56,824,1,,1764
51.58,2560,1,,,51.58,843,1,,1717
51.6,2567,1,,,51.6,854,1,,1713
51.62,2539,1,,,51.62,800,1,,1739
51.64,2540,1,,,51.64,835,1,,1705
51.66,2579,1,,,51.66,818,1,,1761
51.68,2642,1,,,51.68,854,1,,1788
51.7,2602,1,,,51.7,805,1,,1797
51.72,2641,1,,,51.72,782,1,,1859
51.74,2665,1,,,51.74,797,1,,1868
51.76,2644,1,,,51.76,839,1,,1805
51.78,2700,1,,,51.78,822,1,,1878
51.8,2669,1,,,51.8,822,1,,1847
51.82,2671,1,,,51.82,820,1,,1851
51.84,2673,1,,,51.84,803,1,,1870
51.86,2621,1,,,51.86,815,1,,1806
51.88,2537,1,,,51.88,818,1,,1719
51.9,2583,1,,,51.9,820,1,,1763
51.92,2527,1,,,51.92,837,1,,1690
51.94,2637,1,,,51.94,815,1,,1822
51.96,2534,1,,,51.96,832,1,,1702
51.98,2559,1,,,51.98,832,1,,1727
52,2530,1,,,52,813,1,,1717
52.02,2512,1,,,52.02,860,1,,1652
52.04,2469,1,,,52.04,798,1,,1671
52.06,2554,1,,,52.06,836,1,,1718
52.08,2522,1,,,52.08,836,1,,1686
52.1,2532,1,,,52.1,821,1,,1711
52.12,2487,1,,,52.12,842,1,,1645
52.14,2403,1,,,52.14,872,1,,1531
52.16,2534,1,,,52.16,830,1,,1704
52.18,2515,1,,,52.18,810,1,,1705
52.2,2496,1,,,52.2,839,1,,1657
52.22,2474,1,,,52.22,809,1,,1665
52.24,2466,1,,,52.24,823,1,,1643
52.26,2441,1,,,52.26,842,1,,1599
52.28,2524,1,,,52.28,815,1,,1709
52.3,2525,1,,,52.3,792,1,,1733
52.32,2467,1,,,52.32,859,1,,1608
52.34,2482,1,,,52.34,818,1,,1664
52.36,2479,1,,,52.36,839,1,,1640
52.38,2471,1,,,52.38,843,1,,1628
52.4,2461,1,,,52.4,843,1,,1618
52.42,2419,1,,,52.42,871,1,,1548
52.44,2415,1,,,52.44,806,1,,1609
52.46,2440,1,,,52.46,829,1,,1611
52.48,2483,1,,,52.48,851,1,,1632
52.5,2439,1,,,52.5,879,1,,1560
52.52,2435,1,,,52.52,832,1,,1603
52.54,2411,1,,,52.54,823,1,,1588
52.56,2490,1,,,52.56,856,1,,1634
52.58,2386,1,,,52.58,815,1,,1571
52.6,2487,1,,,52.6,857,1,,1630
52.62,2453,1,,,52.62,869,1,,1584
52.64,2374,1,,,52.64,814,1,,1560
52.66,2464,1,,,52.66,811,1,,1653
52.68,2326,1,,,52.68,839,1,,1487
52.7,2453,1,,,52.7,840,1,,1613
52.72,2412,1,,,52.72,841,1,,1571
52.74,2459,1,,,52.74,853,1,,1606
52.76,2406,1,,,52.76,793,1,,1613
52.78,2365,1,,,52.78,811,1,,1554
52.8,2380,1,,,52.8,840,1,,1540
52.82,2443,1,,,52.82,802,1,,1641
52.84,2391,1,,,52.84,797,1,,1594
52.86,2455,1,,,52.86,818,1,,1637
52.88,2450,1,,,52.88,823,1,,1627
52.9,2392,1,,,52.9,824,1,,1568
52.92,2392,1,,,52.92,846,1,,1546
52.94,2398,1,,,52.94,841,1,,1557
52.96,2424,1,,,52.96,836,1,,1588
52.98,2420,1,,,52.98,832,1,,1588
53,2426,1,,,53,840,1,,1586
53.02,2430,1,,,53.02,826,1,,1604
53.04,2438,1,,,53.04,782,1,,1656
53.06,2474,1,,,53.06,812,1,,1662
53.08,2424,1,,,53.08,837,1,,1587
53.1,2404,1,,,53.1,847,1,,1557
53.12,2394,1,,,53.12,798,1,,1596
53.14,2293,1,,,53.14,832,1,,1461
53.16,2412,1,,,53.16,822,1,,1590
53.18,2376,1,,,53.18,848,1,,1528
53.2,2423,1,,,53.2,834,1,,1589
53.22,2306,1,,,53.22,835,1,,1471
53.24,2285,1,,,53.24,815,1,,1470
53.26,2331,1,,,53.26,830,1,,1501
53.28,2438,1,,,53.28,806,1,,1632
53.3,2416,1,,,53.3,815,1,,1601
53.32,2424,1,,,53.32,809,1,,1615
53.34,2403,1,,,53.34,837,1,,1566
53.36,2434,1,,,53.36,819,1,,1615
53.38,2364,1,,,53.38,812,1,,1552
53.4,2284,1,,,53.4,771,1,,1513
53.42,2306,1,,,53.42,863,1,,1443
53.44,2466,1,,,53.44,845,1,,1621
53.46,2422,1,,,53.46,789,1,,1633
53.48,2441,1,,,53.48,860,1,,1581
53.5,2377,1,,,53.5,834,1,,1543
53.52,2381,1,,,53.52,835,1,,1546
53.54,2358,1,,,53.54,820,1,,1538
53.56,2434,1,,,53.56,826,1,,1608
53.58,2372,1,,,53.58,809,1,,1563
53.6,2363,1,,,53.6,829,1,,1534
53.62,2370,1,,,53.62,828,1,,1542
53.64,2456,1,,,53.64,735,1,,1721
53.66,2412,1,,,53.66,781,1,,1631
53.68,2348,1,,,53.68,885,1,,1463
53.7,2435,1,,,53.7,834,1,,1601
53.72,2369,1,,,53.72,827,1,,1542
53.74,2393,1,,,53.74,829,1,,1564
53.76,2482,1,,,53.76,784,1,,1698
53.78,2426,1,,,53.78,799,1,,1627
53.8,2393,1,,,53.8,851,1,,1542
53.82,2469,1,,,53.82,834,1,,1635
53.84,2425,1,,,53.84,826,1,,1599
53.86,2454,1,,,53.86,817,1,,1637
53.88,2379,1,,,53.88,866,1,,1513
53.9,2421,1,,,53.9,858,1,,1563
53.92,2492,1,,,53.92,811,1,,1681
53.94,2503,1,,,53.94,809,1,,1694
53.96,2471,1,,,53.96,799,1,,1672
53.98,2444,1,,,53.98,828,1,,1616
54,2420,1,,,54,850,1,,1570
54.02,2440,1,,,54.02,769,1,,1671
54.04,2416,1,,,54.04,834,1,,1582
54.06,2454,1,,,54.06,846,1,,1608
54.08,2467,1,,,54.08,772,1,,1695
54.1,2488,1,,,54.1,823,1,,1665
54.12,2481,1,,,54.12,854,1,,1627
54.14,2475,1,,,54.14,771,1,,1704
54.16,2458,1,,,54.16,788,1,,1670
54.18,2526,1,,,54.18,850,1,,1676
54.2,2590,1,,,54.2,802,1,,1788
54.22,2570,1,,,54.22,840,1,,1730
54.24,2611,1,,,54.24,834,1,,1777
54.26,2456,1,,,54.26,805,1,,1651
54.28,2581,1,,,54.28,787,1,,1794
54.3,2570,1,,,54.3,817,1,,1753
54.32,2545,1,,,54.32,831,1,,1714
54.34,2523,1,,,54.34,809,1,,1714
54.36,2547,1,,,54.36,842,1,,1705
54.38,2601,1,,,54.38,838,1,,1763
54.4,2659,1,,,54.4,804,1,,1855
54.42,2585,1,,,54.42,854,1,,1731
54.44,2637,1,,,54.44,811,1,,1826
54.46,2585,1,,,54.46,810,1,,1775
54.48,2546,1,,,54.48,838,1,,1708
54.5,2532,1,,,54.5,803,1,,1729
54.52,2447,1,,,54.52,815,1,,1632
54.54,2503,1,,,54.54,804,1,,1699
54.56,2475,1,,,54.56,821,1,,1654
54.58,2503,1,,,54.58,843,1,,1660
54.6,2487,1,,,54.6,847,1,,1640
54.62,2459,1,,,54.62,844,1,,1615
54.64,2434,1,,,54.64,825,1,,1609
54.66,2465,1,,,54.66,824,1,,1641
54.68,2518,1,,,54.68,799,1,,1719
54.7,2470,1,,,54.7,840,1,,1630
54.72,2466,1,,,54.72,797,1,,1669
54.74,2364,1,,,54.74,803,1,,1561
54.76,2401,1,,,54.76,763,1,,1638
54.78,2266,1,,,54.78,849,1,,1417
54.8,2289,1,,,54.8,817,1,,1472
54.82,2428,1,,,54.82,821,1,,1607
54.84,2428,1,,,54.84,823,1,,1605
54.86,2369,1,,,54.86,806,1,,1563
54.88,2391,1,,,54.88,808,1,,1583
54.9,2346,1,,,54.9,839,1,,1507
54.92,2434,1,,,54.92,845,1,,1589
54.94,2414,1,,,54.94,791,1,,1623
54.96,2408,1,,,54.96,857,1,,1551
54.98,2493,1,,,54.98,838,1,,1655
55,2482,1,,,55,831,1,,1651
55.02,2530,1,,,55.02,815,1,,1715
55.04,2487,1,,,55.04,801,1,,1686
55.06,2536,1,,,55.06,737,1,,1799
55.08,2554,1,,,55.08,801,1,,1753
55.1,2465,1,,,55.1,792,1,,1673
55.12,2538,1,,,55.12,798,1,,1740
55.14,2475,1,,,55.14,831,1,,1644
55.16,2468,1,,,55.16,860,1,,1608
55.18,2484,1,,,55.18,793,1,,1691
55.2,2509,1,,,55.2,812,1,,1697
55.22,2411,1,,,55.22,829,1,,1582
55.24,2400,1,,,55.24,831,1,,1569
55.26,2403,1,,,55.26,858,1,,1545
55.28,2398,1,,,55.28,835,1,,1563
55.3,2443,1,,,55.3,821,1,,1622
55.32,2368,1,,,55.32,822,1,,1546
55.34,2355,1,,,55.34,866,1,,1489
55.36,2414,1,,,55.36,817,1,,1597
55.38,2422,1,,,55.38,813,1,,1609
55.4,2386,1,,,55.4,835,1,,1551
55.42,2402,1,,,55.42,812,1,,1590
55.44,2446,1,,,55.44,814,1,,1632
55.46,2399,1,,,55.46,813,1,,1586
55.48,2335,1,,,55.48,812,1,,1523
55.5,2396,1,,,55.5,842,1,,1554
55.52,2450,1,,,55.52,860,1,,1590
55.54,2410,1,,,55.54,802,1,,1608
55.56,2407,1,,,55.56,814,1,,1593
55.58,2364,1,,,55.58,840,1,,1524
55.6,2337,1,,,55.6,798,1,,1539
55.62,2318,1,,,55.62,802,1,,1516
55.64,2399,1,,,55.64,819,1,,1580
55.66,2411,1,,,55.66,813,1,,1598
55.68,2390,1,,,55.68,821,1,,1569
55.7,2321,1,,,55.7,832,1,,1489
55.72,2338,1,,,55.72,762,1,,1576
55.74,2367,1,,,55.74,819,1,,1548
55.76,2391,1,,,55.76,788,1,,1603
55.78,2391,1,,,55.78,813,1,,1578
55.8,2414,1,,,55.8,844,1,,1570
55.82,2355,1,,,55.82,814,1,,1541
55.84,2430,1,,,55.84,801,1,,1629
55.86,2362,1,,,55.86,794,1,,1568
55.88,2364,1,,,55.88,837,1,,1527
55.9,2297,1,,,55.9,806,1,,1491
55.92,2395,1,,,55.92,814,1,,1581
55.94,2416,1,,,55.94,813,1,,1603
55.96,2355,1,,,55.96,815,1,,1540
55.98,2347,1,,,55.98,777,1,,1570
56,2400,1,,,56,808,1,,1592
56.02,2341,1,,,56.02,821,1,,1520
56.04,2342,1,,,56.04,796,1,,1546
56.06,2408,1,,,56.06,799,1,,1609
56.08,2370,1,,,56.08,812,1,,1558
56.1,2372,1,,,56.1,858,1,,1514
56.12,2250,1,,,56.12,882,1,,1368
56.14,2326,1,,,56.14,806,1,,1520
56.16,2311,1,,,56.16,863,1,,1448
56.18,2353,1,,,56.18,826,1,,1527
56.2,2353,1,,,56.2,797,1,,1556
56.22,2313,1,,,56.22,825,1,,1488
56.24,2339,1,,,56.24,792,1,,1547
56.26,2394,1,,,56.26,773,1,,1621
56.28,2395,1,,,56.28,786,1,,1609
56.3,2395,1,,,56.3,789,1,,1606
56.32,2370,1,,,56.32,802,1,,1568
56.34,2293,1,,,56.34,800,1,,1493
56.36,2324,1,,,56.36,827,1,,1497
56.38,2387,1,,,56.38,803,1,,1584
56.4,2385,1,,,56.4,841,1,,1544
56.42,2293,1,,,56.42,800,1,,1493
56.44,2294,1,,,56.44,796,1,,1498
56.46,2311,1,,,56.46,803,1,,1508
56.48,2374,1,,,56.48,809,1,,1565
56.5,2384,1,,,56.5,779,1,,1605
56.52,2303,1,,,56.52,807,1,,1496
56.54,2373,1,,,56.54,830,1,,1543
56.56,2325,1,,,56.56,800,1,,1525
56.58,2380,1,,,56.58,768,1,,1612
56.6,2250,1,,,56.6,831,1,,1419
56.62,2337,1,,,56.62,812,1,,1525
56.64,2356,1,,,56.64,787,1,,1569
56.66,2353,1,,,56.66,805,1,,1548
56.68,2278,1,,,56.68,841,1,,1437
56.7,2348,1,,,56.7,815,1,,1533
56.72,2383,1,,,56.72,807,1,,1576
56.74,2310,1,,,56.74,797,1,,1513
56.76,2307,1,,,56.76,810,1,,1497
56.78,2357,1,,,56.78,787,1,,1570
56.8,2236,1,,,56.8,837,1,,1399
56.82,2336,1,,,56.82,809,1,,1527
56.84,2301,1,,,56.84,840,1,,1461
56.86,2252,1,,,56.86,800,1,,1452
56.88,2302,1,,,56.88,778,1,,1524
56.9,2327,1,,,56.9,836,1,,1491
56.92,2315,1,,,56.92,832,1,,1483
56.94,2225,1,,,56.94,775,1,,1450
56.96,2286,1,,,56.96,772,1,,1514
56.98,2276,1,,,56.98,803,1,,1473
57,2320,1,,,57,807,1,,1513
57.02,2235,1,,,57.02,768,1,,1467
57.04,2280,1,,,57.04,802,1,,1478
57.06,2265,1,,,57.06,808,1,,1457
57.08,2246,1,,,57.08,807,1,,1439
57.1,2279,1,,,57.1,785,1,,1494
57.12,2291,1,,,57.12,777,1,,1514
57.14,2248,1,,,57.14,777,1,,1471
57.16,2285,1,,,57.16,775,1,,1510
57.18,2427,1,,,57.18,778,1,,1649
57.2,2279,1,,,57.2,790,1,,1489
57.22,2279,1,,,57.22,801,1,,1478
57.24,2276,1,,,57.24,829,1,,1447
57.26,2330,1,,,57.26,818,1,,1512
57.28,2281,1,,,57.28,869,1,,1412
57.3,2337,1,,,57.3,823,1,,1514
57.32,2312,1,,,57.32,812,1,,1500
57.34,2387,1,,,57.34,829,1,,1558
57.36,2366,1,,,57.36,794,1,,1572
57.38,2343,1,,,57.38,832,1,,1511
57.4,2333,1,,,57.4,790,1,,1543
57.42,2226,1,,,57.42,828,1,,1398
57.44,2246,1,,,57.44,834,1,,1412
57.46,2363,1,,,57.46,773,1,,1590
57.48,2295,1,,,57.48,837,1,,1458
57.5,2292,1,,,57.5,816,1,,1476
57.52,2340,1,,,57.52,831,1,,1509
57.54,2379,1,,,57.54,851,1,,1528
57.56,2347,1,,,57.56,818,1,,1529
57.58,2323,1,,,57.58,799,1,,1524
57.6,2480,1,,,57.6,801,1,,1679
57.62,2425,1,,,57.62,854,1,,1571
57.64,2412,1,,,57.64,798,1,,1614
57.66,2393,1,,,57.66,827,1,,1566
57.68,2413,1,,,57.68,820,1,,1593
57.7,2311,1,,,57.7,855,1,,1456
57.72,2306,1,,,57.72,800,1,,1506
57.74,2429,1,,,57.74,793,1,,1636
57.76,2454,1,,,57.76,801,1,,1653
57.78,2369,1,,,57.78,795,1,,1574
57.8,2330,1,,,57.8,814,1,,1516
57.82,2331,1,,,57.82,820,1,,1511
57.84,2300,1,,,57.84,774,1,,1526
57.86,2302,1,,,57.86,806,1,,1496
57.88,2373,1,,,57.88,850,1,,1523
57.9,2329,1,,,57.9,822,1,,1507
57.92,2245,1,,,57.92,819,1,,1426
57.94,2306,1,,,57.94,820,1,,1486
57.96,2386,1,,,57.96,814,1,,1572
57.98,2370,1,,,57.98,829,1,,1541
58,2344,1,,,58,814,1,,1530
58.02,2275,1,,,58.02,803,1,,1472
58.04,2336,1,,,58.04,791,1,,1545
58.06,2295,1,,,58.06,810,1,,1485
58.08,2331,1,,,58.08,812,1,,1519
58.1,2337,1,,,58.1,875,1,,1462
58.12,2314,1,,,58.12,822,1,,1492
58.14,2266,1,,,58.14,790,1,,1476
58.16,2355,1,,,58.16,805,1,,1550
58.18,2280,1,,,58.18,833,1,,1447
58.2,2361,1,,,58.2,805,1,,1556
58.22,2395,1,,,58.22,825,1,,1570
58.24,2294,1,,,58.24,833,1,,1461
58.26,2323,1,,,58.26,826,1,,1497
58.28,2341,1,,,58.28,792,1,,1549
58.3,2311,1,,,58.3,787,1,,1524
58.32,2393,1,,,58.32,849,1,,1544
58.34,2363,1,,,58.34,830,1,,1533
58.36,2339,1,,,58.36,848,1,,1491
58.38,2360,1,,,58.38,853,1,,1507
58.4,2340,1,,,58.4,796,1,,1544
58.42,2324,1,,,58.42,830,1,,1494
58.44,2380,1,,,58.44,795,1,,1585
58.46,2471,1,,,58.46,842,1,,1629
58.48,2405,1,,,58.48,832,1,,1573
58.5,2310,1,,,58.5,804,1,,1506
58.52,2383,1,,,58.52,768,1,,1615
58.54,2403,1,,,58.54,767,1,,1636
58.56,2421,1,,,58.56,777,1,,1644
58.58,2344,1,,,58.58,789,1,,1555
58.6,2394,1,,,58.6,786,1,,1608
58.62,2438,1,,,58.62,847,1,,1591
58.64,2371,1,,,58.64,811,1,,1560
58.66,2340,1,,,58.66,803,1,,1537
58.68,2318,1,,,58.68,807,1,,1511
58.7,2432,1,,,58.7,842,1,,1590
58.72,2360,1,,,58.72,801,1,,1559
58.74,2371,1,,,58.74,805,1,,1566
58.76,2384,1,,,58.76,786,1,,1598
58.78,2353,1,,,58.78,816,1,,1537
58.8,2359,1,,,58.8,858,1,,1501
58.82,2444,1,,,58.82,844,1,,1600
58.84,2351,1,,,58.84,869,1,,1482
58.86,2341,1,,,58.86,796,1,,1545
58.88,2404,1,,,58.88,809,1,,1595
58.9,2362,1,,,58.9,814,1,,1548
58.92,2334,1,,,58.92,801,1,,1533
58.94,2367,1,,,58.94,798,1,,1569
58.96,2354,1,,,58.96,796,1,,1558
58.98,2340,1,,,58.98,874,1,,1466
59,2333,1,,,59,802,1,,1531
59.02,2382,1,,,59.02,813,1,,1569
59.04,2378,1,,,59.04,855,1,,1523
59.06,2305,1,,,59.06,790,1,,1515
59.08,2313,1,,,59.08,795,1,,1518
59.1,2385,1,,,59.1,807,1,,1578
59.12,2351,1,,,59.12,855,1,,1496
59.14,2376,1,,,59.14,812,1,,1564
59.16,2377,1,,,59.16,788,1,,1589
59.18,2381,1,,,59.18,798,1,,1583
59.2,2388,1,,,59.2,804,1,,1584
59.22,2387,1,,,59.22,846,1,,1541
59.24,2304,1,,,59.24,806,1,,1498
59.26,2344,1,,,59.26,795,1,,1549
59.28,2304,1,,,59.28,823,1,,1481
59.3,2318,1,,,59.3,805,1,,1513
59.32,2305,1,,,59.32,850,1,,1455
59.34,2372,1,,,59.34,786,1,,1586
59.36,2228,1,,,59.36,809,1,,1419
59.38,2315,1,,,59.38,847,1,,1468
59.4,2311,1,,,59.4,755,1,,1556
59.42,2271,1,,,59.42,799,1,,1472
59.44,2277,1,,,59.44,771,1,,1506
59.46,2286,1,,,59.46,779,1,,1507
59.48,2249,1,,,59.48,803,1,,1446
59.5,2336,1,,,59.5,811,1,,1525
59.52,2271,1,,,59.52,822,1,,1449
59.54,2238,1,,,59.54,802,1,,1436
59.56,2236,1,,,59.56,754,1,,1482
59.58,2264,1,,,59.58,751,1,,1513
59.6,2314,1,,,59.6,858,1,,1456
59.62,2286,1,,,59.62,822,1,,1464
59.64,2204,1,,,59.64,795,1,,1409
59.66,2281,1,,,59.66,852,1,,1429
59.68,2233,1,,,59.68,815,1,,1418
59.7,2304,1,,,59.7,785,1,,1519
59.72,2274,1,,,59.72,827,1,,1447
59.74,2291,1,,,59.74,832,1,,1459
59.76,2345,1,,,59.76,788,1,,1557
59.78,2254,1,,,59.78,768,1,,1486
59.8,2373,1,,,59.8,793,1,,1580
59.82,2276,1,,,59.82,785,1,,1491
59.84,2242,1,,,59.84,772,1,,1470
59.86,2319,1,,,59.86,842,1,,1477
59.88,2286,1,,,59.88,837,1,,1449
59.9,2296,1,,,59.9,808,1,,1488
59.92,2313,1,,,59.92,780,1,,1533
59.94,2273,1,,,59.94,826,1,,1447
59.96,2271,1,,,59.96,810,1,,1461
59.98,2262,1,,,59.98,758,1,,1504
60,2272,1,,,60,825,1,,1447
60.02,2215,1,,,60.02,763,1,,1452
60.04,2222,1,,,60.04,787,1,,1435
60.06,2339,1,,,60.06,796,1,,1543
60.08,2202,1,,,60.08,775,1,,1427
60.1,2277,1,,,60.1,836,1,,1441
60.12,2247,1,,,60.12,859,1,,1388
60.14,2270,1,,,60.14,806,1,,1464
60.16,2243,1,,,60.16,769,1,,1474
60.18,2291,1,,,60.18,849,1,,1442
60.2,2326,1,,,60.2,754,1,,1572
60.22,2315,1,,,60.22,791,1,,1524
60.24,2223,1,,,60.24,800,1,,1423
60.26,2272,1,,,60.26,768,1,,1504
60.28,2298,1,,,60.28,817,1,,1481
60.3,2324,1,,,60.3,852,1,,1472
60.32,2256,1,,,60.32,759,1,,1497
60.34,2238,1,,,60.34,827,1,,1411
60.36,2256,1,,,60.36,848,1,,1408
60.38,2268,1,,,60.38,779,1,,1489
60.4,2305,1,,,60.4,815,1,,1490
60.42,2223,1,,,60.42,816,1,,1407
60.44,2282,1,,,60.44,792,1,,1490
60.46,2252,1,,,60.46,793,1,,1459
60.48,2234,1,,,60.48,810,1,,1424
60.5,2257,1,,,60.5,795,1,,1462
60.52,2247,1,,,60.52,829,1,,1418
60.54,2240,1,,,60.54,810,1,,1430
60.56,2236,1,,,60.56,812,1,,1424
60.58,2217,1,,,60.58,820,1,,1397
60.6,2261,1,,,60.6,846,1,,1415
60.62,2253,1,,,60.62,781,1,,1472
60.64,2246,1,,,60.64,783,1,,1463
60.66,2244,1,,,60.66,818,1,,1426
60.68,2186,1,,,60.68,826,1,,1360
60.7,2209,1,,,60.7,821,1,,1388
60.72,2220,1,,,60.72,841,1,,1379
60.74,2309,1,,,60.74,801,1,,1508
60.76,2252,1,,,60.76,792,1,,1460
60.78,2264,1,,,60.78,807,1,,1457
60.8,2311,1,,,60.8,800,1,,1511
60.82,2352,1,,,60.82,763,1,,1589
60.84,2271,1,,,60.84,787,1,,1484
60.86,2278,1,,,60.86,767,1,,1511
60.88,2289,1,,,60.88,778,1,,1511
60.9,2349,1,,,60.9,751,1,,1598
60.92,2256,1,,,60.92,811,1,,1445
60.94,2284,1,,,60.94,817,1,,1467
60.96,2296,1,,,60.96,823,1,,1473
60.98,2328,1,,,60.98,804,1,,1524
61,2277,1,,,61,788,1,,1489
61.02,2303,1,,,61.02,745,1,,1558
61.04,2235,1,,,61.04,785,1,,1450
61.06,2317,1,,,61.06,791,1,,1526
61.08,2392,1,,,61.08,832,1,,1560
61.1,2325,1,,,61.1,792,1,,1533
61.12,2367,1,,,61.12,791,1,,1576
61.14,2272,1,,,61.14,776,1,,1496
61.16,2317,1,,,61.16,776,1,,1541
61.18,2317,1,,,61.18,797,1,,1520
61.2,2302,1,,,61.2,783,1,,1519
61.22,2206,1,,,61.22,812,1,,1394
61.24,2240,1,,,61.24,821,1,,1419
61.26,2224,1,,,61.26,821,1,,1403
61.28,2277,1,,,61.28,828,1,,1449
61.3,2284,1,,,61.3,804,1,,1480
61.32,2236,1,,,61.32,803,1,,1433
61.34,2271,1,,,61.34,794,1,,1477
61.36,2217,1,,,61.36,802,1,,1415
61.38,2310,1,,,61.38,802,1,,1508
61.4,2274,1,,,61.4,809,1,,1465
61.42,2287,1,,,61.42,759,1,,1528
61.44,2274,1,,,61.44,797,1,,1477
61.46,2254,1,,,61.46,791,1,,1463
61.48,2274,1,,,61.48,774,1,,1500
61.5,2322,1,,,61.5,851,1,,1471
61.52,2262,1,,,61.52,745,1,,1517
61.54,2216,1,,,61.54,782,1,,1434
61.56,2263,1,,,61.56,788,1,,1475
61.58,2198,1,,,61.58,836,1,,1362
61.6,2271,1,,,61.6,812,1,,1459
61.62,2298,1,,,61.62,804,1,,1494
61.64,2320,1,,,61.64,831,1,,1489
61.66,2281,1,,,61.66,811,1,,1470
61.68,2310,1,,,61.68,785,1,,1525
61.7,2294,1,,,61.7,777,1,,1517
61.72,2249,1,,,61.72,793,1,,1456
61.74,2296,1,,,61.74,828,1,,1468
61.76,2328,1,,,61.76,779,1,,1549
61.78,2330,1,,,61.78,823,1,,1507
61.8,2439,1,,,61.8,797,1,,1642
61.82,2303,1,,,61.82,816,1,,1487
61.84,2341,1,,,61.84,748,1,,1593
61.86,2406,1,,,61.86,772,1,,1634
61.88,2350,1,,,61.88,776,1,,1574
61.9,2306,1,,,61.9,794,1,,1512
61.92,2312,1,,,61.92,809,1,,1503
61.94,2328,1,,,61.94,796,1,,1532
61.96,2324,1,,,61.96,782,1,,1542
61.98,2291,1,,,61.98,807,1,,1484
62,2307,1,,,62,768,1,,1539
62.02,2288,1,,,62.02,800,1,,1488
62.04,2324,1,,,62.04,832,1,,1492
62.06,2330,1,,,62.06,827,1,,1503
62.08,2328,1,,,62.08,789,1,,1539
62.1,2241,1,,,62.1,793,1,,1448
62.12,2357,1,,,62.12,768,1,,1589
62.14,2300,1,,,62.14,750,1,,1550
62.16,2248,1,,,62.16,812,1,,1436
62.18,2273,1,,,62.18,823,1,,1450
62.2,2292,1,,,62.2,816,1,,1476
62.22,2268,1,,,62.22,784,1,,1484
62.24,2268,1,,,62.24,770,1,,1498
62.26,2319,1,,,62.26,809,1,,1510
62.28,2276,1,,,62.28,776,1,,1500
62.3,2312,1,,,62.3,780,1,,1532
62.32,2320,1,,,62.32,791,1,,1529
62.34,2314,1,,,62.34,809,1,,1505
62.36,2323,1,,,62.36,788,1,,1535
62.38,2260,1,,,62.38,820,1,,1440
62.4,2280,1,,,62.4,814,1,,1466
62.42,2233,1,,,62.42,755,1,,1478
62.44,2267,1,,,62.44,796,1,,1471
62.46,2306,1,,,62.46,777,1,,1529
62.48,2229,1,,,62.48,743,1,,1486
62.5,2324,1,,,62.5,781,1,,1543
62.52,2254,1,,,62.52,794,1,,1460
62.54,2221,1,,,62.54,776,1,,1445
62.56,2246,1,,,62.56,766,1,,1480
62.58,2204,1,,,62.58,775,1,,1429
62.6,2342,1,,,62.6,778,1,,1564
62.62,2223,1,,,62.62,776,1,,1447
62.64,2232,1,,,62.64,811,1,,1421
62.66,2234,1,,,62.66,789,1,,1445
62.68,2271,1,,,62.68,802,1,,1469
62.7,2209,1,,,62.7,801,1,,1408
62.72,2208,1,,,62.72,828,1,,1380
62.74,2260,1,,,62.74,805,1,,1455
62.76,2198,1,,,62.76,783,1,,1415
62.78,2285,1,,,62.78,777,1,,1508
62.8,2266,1,,,62.8,779,1,,1487
62.82,2288,1,,,62.82,771,1,,1517
62.84,2213,1,,,62.84,757,1,,1456
62.86,2244,1,,,62.86,792,1,,1452
62.88,2213,1,,,62.88,752,1,,1461
62.9,2198,1,,,62.9,789,1,,1409
62.92,2215,1,,,62.92,806,1,,1409
62.94,2235,1,,,62.94,800,1,,1435
62.96,2283,1,,,62.96,827,1,,1456
62.98,2285,1,,,62.98,754,1,,1531
63,2325,1,,,63,743,1,,1582
63.02,2148,1,,,63.02,775,1,,1373
63.04,2296,1,,,63.04,723,1,,1573
63.06,2184,1,,,63.06,788,1,,1396
63.08,2250,1,,,63.08,759,1,,1491
63.1,2244,1,,,63.1,768,1,,1476
63.12,2348,1,,,63.12,831,1,,1517
63.14,2274,1,,,63.14,773,1,,1501
63.16,2294,1,,,63.16,777,1,,1517
63.18,2268,1,,,63.18,818,1,,1450
63.2,2300,1,,,63.2,789,1,,1511
63.22,2308,1,,,63.22,758,1,,1550
63.24,2283,1,,,63.24,793,1,,1490
63.26,2218,1,,,63.26,797,1,,1421
63.28,2273,1,,,63.28,782,1,,1491
63.3,2265,1,,,63.3,796,1,,1469
63.32,2268,1,,,63.32,776,1,,1492
63.34,2356,1,,,63.34,771,1,,1585
63.36,2245,1,,,63.36,769,1,,1476
63.38,2298,1,,,63.38,751,1,,1547
63.4,2254,1,,,63.4,809,1,,1445
63.42,2284,1,,,63.42,758,1,,1526
63.44,2144,1,,,63.44,771,1,,1373
63.46,2222,1,,,63.46,802,1,,1420
63.48,2217,1,,,63.48,753,1,,1464
63.5,2177,1,,,63.5,843,1,,1334
63.52,2233,1,,,63.52,818,1,,1415
63.54,2284,1,,,63.54,773,1,,1511
63.56,2273,1,,,63.56,783,1,,1490
63.58,2290,1,,,63.58,783,1,,1507
63.6,2292,1,,,63.6,825,1,,1467
63.62,2336,1,,,63.62,813,1,,1523
63.64,2362,1,,,63.64,762,1,,1600
63.66,2271,1,,,63.66,752,1,,1519
63.68,2261,1,,,63.68,771,1,,1490
63.7,2301,1,,,63.7,787,1,,1514
63.72,2287,1,,,63.72,766,1,,1521
63.74,2268,1,,,63.74,758,1,,1510
63.76,2276,1,,,63.76,760,1,,1516
63.78,2416,1,,,63.78,787,1,,1629
63.8,2440,1,,,63.8,796,1,,1644
63.82,2360,1,,,63.82,757,1,,1603
63.84,2372,1,,,63.84,772,1,,1600
63.86,2361,1,,,63.86,759,1,,1602
63.88,2337,1,,,63.88,764,1,,1573
63.9,2409,1,,,63.9,757,1,,1652
63.92,2343,1,,,63.92,820,1,,1523
63.94,2448,1,,,63.94,804,1,,1644
63.96,2426,1,,,63.96,799,1,,1627
63.98,2390,1,,,63.98,758,1,,1632
64,2398,1,,,64,788,1,,1610
64.02,2479,1,,,64.02,829,1,,1650
64.04,2368,1,,,64.04,816,1,,1552
64.06,2346,1,,,64.06,770,1,,1576
64.08,2427,1,,,64.08,768,1,,1659
64.1,2502,1,,,64.1,769,1,,1733
64.12,2471,1,,,64.12,744,1,,1727
64.14,2521,1,,,64.14,801,1,,1720
64.16,2469,1,,,64.16,795,1,,1674
64.18,2569,1,,,64.18,727,1,,1842
64.2,2610,1,,,64.2,712,1,,1898
64.22,2623,1,,,64.22,788,1,,1835
64.24,2579,1,,,64.24,836,1,,1743
64.26,2664,1,,,64.26,746,1,,1918
64.28,2733,1,,,64.28,779,1,,1954
64.3,2703,1,,,64.3,780,1,,1923
64.32,2853,1,,,64.32,755,1,,2098
64.34,2781,1,,,64.34,754,1,,2027
64.36,2904,1,,,64.36,827,1,,2077
64.38,2856,1,,,64.38,820,1,,2036
64.4,2850,1,,,64.4,789,1,,2061
64.42,2915,1,,,64.42,774,1,,2141
64.44,2798,1,,,64.44,751,1,,2047
64.46,2800,1,,,64.46,736,1,,2064
64.48,2798,1,,,64.48,757,1,,2041
64.5,2757,1,,,64.5,773,1,,1984
64.52,2761,1,,,64.52,769,1,,1992
64.54,2813,1,,,64.54,790,1,,2023
64.56,2795,1,,,64.56,780,1,,2015
64.58,2654,1,,,64.58,786,1,,1868
64.6,2704,1,,,64.6,779,1,,1925
64.62,2623,1,,,64.62,718,1,,1905
64.64,2722,1,,,64.64,742,1,,1980
64.66,2686,1,,,64.66,764,1,,1922
64.68,2583,1,,,64.68,766,1,,1817
64.7,2586,1,,,64.7,808,1,,1778
64.72,2585,1,,,64.72,776,1,,1809
64.74,2545,1,,,64.74,751,1,,1794
64.76,2509,1,,,64.76,816,1,,1693
64.78,2474,1,,,64.78,785,1,,1689
64.8,2503,1,,,64.8,727,1,,1776
64.82,2494,1,,,64.82,757,1,,1737
64.84,2502,1,,,64.84,814,1,,1688
64.86,2471,1,,,64.86,816,1,,1655
64.88,2379,1,,,64.88,742,1,,1637
64.9,2407,1,,,64.9,783,1,,1624
64.92,2308,1,,,64.92,826,1,,1482
64.94,2273,1,,,64.94,706,1,,1567
64.96,2328,1,,,64.96,716,1,,1612
64.98,2318,1,,,64.98,748,1,,1570
65,2383,1,,,65,775,1,,1608
65.02,2383,1,,,65.02,821,1,,1562
65.04,2297,1,,,65.04,766,1,,1531
65.06,2280,1,,,65.06,796,1,,1484
65.08,2216,1,,,65.08,746,1,,1470
65.1,2241,1,,,65.1,736,1,,1505
65.12,2298,1,,,65.12,720,1,,1578
65.14,2348,1,,,65.14,827,1,,1521
65.16,2365,1,,,65.16,793,1,,1572
65.18,2375,1,,,65.18,753,1,,1622
65.2,2257,1,,,65.2,764,1,,1493
65.22,2274,1,,,65.22,757,1,,1517
65.24,2290,1,,,65.24,717,1,,1573
65.26,2280,1,,,65.26,752,1,,1528
65.28,2284,1,,,65.28,730,1,,1554
65.3,2281,1,,,65.3,716,1,,1565
65.32,2238,1,,,65.32,685,1,,1553
65.34,2281,1,,,65.34,728,1,,1553
65.36,2304,1,,,65.36,794,1,,1510
65.38,2141,1,,,65.38,734,1,,1407
65.4,2245,1,,,65.4,719,1,,1526
65.42,2329,1,,,65.42,711,1,,1618
65.44,2220,1,,,65.44,753,1,,1467
65.46,2234,1,,,65.46,747,1,,1487
65.48,2162,1,,,65.48,752,1,,1410
65.5,2273,1,,,65.5,723,1,,1550
65.52,2194,1,,,65.52,722,1,,1472
65.54,2274,1,,,65.54,719,1,,1555
65.56,2271,1,,,65.56,740,1,,1531
65.58,2228,1,,,65.58,754,1,,1474
65.6,2191,1,,,65.6,769,1,,1422
65.62,2215,1,,,65.62,752,1,,1463
65.64,2251,1,,,65.64,745,1,,1506
65.66,2089,1,,,65.66,747,1,,1342
65.68,2206,1,,,65.68,763,1,,1443
65.7,2197,1,,,65.7,749,1,,1448
65.72,2191,1,,,65.72,717,1,,1474
65.74,2116,1,,,65.74,767,1,,1349
65.76,2096,1,,,65.76,795,1,,1301
65.78,2134,1,,,65.78,753,1,,1381
65.8,2146,1,,,65.8,752,1,,1394
65.82,2147,1,,,65.82,771,1,,1376
65.84,2210,1,,,65.84,734,1,,1476
65.86,2166,1,,,65.86,722,1,,1444
65.88,2171,1,,,65.88,726,1,,1445
65.9,2166,1,,,65.9,738,1,,1428
65.92,2189,1,,,65.92,746,1,,1443
65.94,2134,1,,,65.94,732,1,,1402
65.96,2149,1,,,65.96,734,1,,1415
65.98,2116,1,,,65.98,762,1,,1354
66,2132,1,,,66,790,1,,1342
66.02,2115,1,,,66.02,731,1,,1384
66.04,2064,1,,,66.04,748,1,,1316
66.06,2171,1,,,66.06,772,1,,1399
66.08,2103,1,,,66.08,746,1,,1357
66.1,2143,1,,,66.1,706,1,,1437
66.12,2151,1,,,66.12,719,1,,1432
66.14,2065,1,,,66.14,735,1,,1330
66.16,2130,1,,,66.16,753,1,,1377
66.18,2078,1,,,66.18,734,1,,1344
66.2,2179,1,,,66.2,735,1,,1444
66.22,2116,1,,,66.22,764,1,,1352
66.24,2099,1,,,66.24,742,1,,1357
66.26,2145,1,,,66.26,742,1,,1403
66.28,2099,1,,,66.28,728,1,,1371
66.3,2146,1,,,66.3,724,1,,1422
66.32,2099,1,,,66.32,742,1,,1357
66.34,2075,1,,,66.34,767,1,,1308
66.36,2073,1,,,66.36,738,1,,1335
66.38,2059,1,,,66.38,678,1,,1381
66.4,2116,1,,,66.4,725,1,,1391
66.42,2165,1,,,66.42,744,1,,1421
66.44,2175,1,,,66.44,764,1,,1411
66.46,2133,1,,,66.46,762,1,,1371
66.48,2055,1,,,66.48,713,1,,1342
66.5,2099,1,,,66.5,724,1,,1375
66.52,2081,1,,,66.52,724,1,,1357
66.54,2111,1,,,66.54,745,1,,1366
66.56,2064,1,,,66.56,762,1,,1302
66.58,2044,1,,,66.58,735,1,,1309
66.6,2110,1,,,66.6,727,1,,1383
66.62,2065,1,,,66.62,728,1,,1337
66.64,2108,1,,,66.64,734,1,,1374
66.66,2088,1,,,66.66,737,1,,1351
66.68,2051,1,,,66.68,717,1,,1334
66.7,2141,1,,,66.7,704,1,,1437
66.72,2136,1,,,66.72,732,1,,1404
66.74,2096,1,,,66.74,747,1,,1349
66.76,2129,1,,,66.76,680,1,,1449
66.78,2087,1,,,66.78,750,1,,1337
66.8,2045,1,,,66.8,733,1,,1312
66.82,2069,1,,,66.82,713,1,,1356
66.84,2088,1,,,66.84,755,1,,1333
66.86,2113,1,,,66.86,756,1,,1357
66.88,2069,1,,,66.88,729,1,,1340
66.9,2082,1,,,66.9,772,1,,1310
66.92,2075,1,,,66.92,741,1,,1334
66.94,2101,1,,,66.94,710,1,,1391
66.96,2113,1,,,66.96,712,1,,1401
66.98,2061,1,,,66.98,716,1,,1345
67,2031,1,,,67,717,1,,1314
67.02,2109,1,,,67.02,773,1,,1336
67.04,2085,1,,,67.04,723,1,,1362
67.06,2013,1,,,67.06,712,1,,1301
67.08,2094,1,,,67.08,740,1,,1354
67.1,2123,1,,,67.1,739,1,,1384
67.12,2018,1,,,67.12,710,1,,1308
67.14,2163,1,,,67.14,730,1,,1433
67.16,2066,1,,,67.16,733,1,,1333
67.18,2070,1,,,67.18,688,1,,1382
67.2,2073,1,,,67.2,693,1,,1380
67.22,2052,1,,,67.22,724,1,,1328
67.24,2067,1,,,67.24,747,1,,1320
67.26,2010,1,,,67.26,720,1,,1290
67.28,2020,1,,,67.28,724,1,,1296
67.3,2047,1,,,67.3,711,1,,1336
67.32,2030,1,,,67.32,717,1,,1313
67.34,2059,1,,,67.34,718,1,,1341
67.36,2081,1,,,67.36,716,1,,1365
67.38,2067,1,,,67.38,697,1,,1370
67.4,2049,1,,,67.4,699,1,,1350
67.42,2015,1,,,67.42,731,1,,1284
67.44,2099,1,,,67.44,713,1,,1386
67.46,2105,1,,,67.46,691,1,,1414
67.48,2047,1,,,67.48,720,1,,1327
67.5,2061,1,,,67.5,728,1,,1333
67.52,2061,1,,,67.52,729,1,,1332
67.54,2060,1,,,67.54,660,1,,1400
67.56,2050,1,,,67.56,696,1,,1354
67.58,1994,1,,,67.58,695,1,,1299
67.6,2087,1,,,67.6,735,1,,1352
67.62,2057,1,,,67.62,724,1,,1333
67.64,1944,1,,,67.64,732,1,,1212
67.66,2020,1,,,67.66,711,1,,1309
67.68,1998,1,,,67.68,687,1,,1311
67.7,2097,1,,,67.7,705,1,,1392
67.72,2099,1,,,67.72,696,1,,1403
67.74,2077,1,,,67.74,716,1,,1361
67.76,2003,1,,,67.76,740,1,,1263
67.78,2037,1,,,67.78,698,1,,1339
67.8,2002,1,,,67.8,722,1,,1280
67.82,2099,1,,,67.82,743,1,,1356
67.84,2082,1,,,67.84,749,1,,1333
67.86,2107,1,,,67.86,694,1,,1413
67.88,2067,1,,,67.88,728,1,,1339
67.9,1997,1,,,67.9,698,1,,1299
67.92,2060,1,,,67.92,704,1,,1356
67.94,2094,1,,,67.94,711,1,,1383
67.96,1948,1,,,67.96,700,1,,1248
67.98,2082,1,,,67.98,677,1,,1405
68,2079,1,,,68,707,1,,1372
68.02,2051,1,,,68.02,699,1,,1352
68.04,2047,1,,,68.04,744,1,,1303
68.06,2008,1,,,68.06,715,1,,1293
68.08,2012,1,,,68.08,689,1,,1323
68.1,2046,1,,,68.1,720,1,,1326
68.12,2095,1,,,68.12,725,1,,1370
68.14,2021,1,,,68.14,709,1,,1312
68.16,1959,1,,,68.16,691,1,,1268
68.18,2005,1,,,68.18,769,1,,1236
68.2,2060,1,,,68.2,674,1,,1386
68.22,2060,1,,,68.22,686,1,,1374
68.24,2089,1,,,68.24,711,1,,1378
68.26,2025,1,,,68.26,679,1,,1346
68.28,2009,1,,,68.28,674,1,,1335
68.3,2042,1,,,68.3,693,1,,1349
68.32,2006,1,,,68.32,725,1,,1281
68.34,1992,1,,,68.34,716,1,,1276
68.36,1985,1,,,68.36,702,1,,1283
68.38,1982,1,,,68.38,746,1,,1236
68.4,2034,1,,,68.4,707,1,,1327
68.42,2064,1,,,68.42,722,1,,1342
68.44,2056,1,,,68.44,714,1,,1342
68.46,2048,1,,,68.46,691,1,,1357
68.48,1991,1,,,68.48,754,1,,1237
68.5,2041,1,,,68.5,730,1,,1311
68.52,2014,1,,,68.52,693,1,,1321
68.54,2008,1,,,68.54,693,1,,1315
68.56,1968,1,,,68.56,659,1,,1309
68.58,2039,1,,,68.58,676,1,,1363
68.6,2120,1,,,68.6,686,1,,1434
68.62,2112,1,,,68.62,665,1,,1447
68.64,2002,1,,,68.64,659,1,,1343
68.66,2001,1,,,68.66,693,1,,1308
68.68,1947,1,,,68.68,679,1,,1268
68.7,2069,1,,,68.7,690,1,,1379
68.72,2061,1,,,68.72,680,1,,1381
68.74,2027,1,,,68.74,712,1,,1315
68.76,2050,1,,,68.76,703,1,,1347
68.78,2068,1,,,68.78,700,1,,1368
68.8,1994,1,,,68.8,685,1,,1309
68.82,2148,1,,,68.82,684,1,,1464
68.84,2084,1,,,68.84,691,1,,1393
68.86,1975,1,,,68.86,716,1,,1259
68.88,2078,1,,,68.88,671,1,,1407
68.9,2095,1,,,68.9,680,1,,1415
68.92,2028,1,,,68.92,645,1,,1383
68.94,2036,1,,,68.94,665,1,,1371
68.96,2079,1,,,68.96,702,1,,1377
68.98,1982,1,,,68.98,723,1,,1259
69,2019,1,,,69,688,1,,1331
69.02,2019,1,,,69.02,684,1,,1335
69.04,2051,1,,,69.04,757,1,,1294
69.06,2001,1,,,69.06,651,1,,1350
69.08,1929,1,,,69.08,655,1,,1274
69.1,1978,1,,,69.1,705,1,,1273
69.12,2015,1,,,69.12,663,1,,1352
69.14,2031,1,,,69.14,680,1,,1351
69.16,1966,1,,,69.16,663,1,,1303
69.18,1979,1,,,69.18,679,1,,1300
69.2,2053,1,,,69.2,669,1,,1384
69.22,1969,1,,,69.22,687,1,,1282
69.24,1938,1,,,69.24,705,1,,1233
69.26,1956,1,,,69.26,689,1,,1267
69.28,1948,1,,,69.28,660,1,,1288
69.3,1977,1,,,69.3,646,1,,1331
69.32,1934,1,,,69.32,666,1,,1268
69.34,1956,1,,,69.34,658,1,,1298
69.36,1981,1,,,69.36,686,1,,1295
69.38,1964,1,,,69.38,671,1,,1293
69.4,1955,1,,,69.4,704,1,,1251
69.42,1997,1,,,69.42,672,1,,1325
69.44,1939,1,,,69.44,693,1,,1246
69.46,2002,1,,,69.46,665,1,,1337
69.48,1945,1,,,69.48,684,1,,1261
69.5,1903,1,,,69.5,633,1,,1270
69.52,1948,1,,,69.52,687,1,,1261
69.54,1984,1,,,69.54,637,1,,1347
69.56,1916,1,,,69.56,663,1,,1253
69.58,1934,1,,,69.58,701,1,,1233
69.6,1963,1,,,69.6,687,1,,1276
69.62,1956,1,,,69.62,680,1,,1276
69.64,1940,1,,,69.64,659,1,,1281
69.66,1923,1,,,69.66,667,1,,1256
69.68,1943,1,,,69.68,646,1,,1297
69.7,1983,1,,,69.7,664,1,,1319
69.72,1912,1,,,69.72,651,1,,1261
69.74,1982,1,,,69.74,709,1,,1273
69.76,1962,1,,,69.76,678,1,,1284
69.78,2066,1,,,69.78,684,1,,1382
69.8,1891,1,,,69.8,663,1,,1228
69.82,2011,1,,,69.82,630,1,,1381
69.84,2049,1,,,69.84,680,1,,1369
69.86,1989,1,,,69.86,650,1,,1339
69.88,1931,1,,,69.88,734,1,,1197
69.9,1944,1,,,69.9,708,1,,1236
69.92,1946,1,,,69.92,708,1,,1238
69.94,1998,1,,,69.94,712,1,,1286
69.96,1909,1,,,69.96,628,1,,1281
69.98,1844,1,,,69.98,638,1,,1206
70,1957,1,,,70,676,1,,1281
70.02,1929,1,,,70.02,664,1,,1265
70.04,1993,1,,,70.04,650,1,,1343
70.06,1899,1,,,70.06,644,1,,1255
70.08,1944,1,,,70.08,645,1,,1299
70.1,1919,1,,,70.1,713,1,,1206
70.12,1906,1,,,70.12,668,1,,1238
70.14,1928,1,,,70.14,674,1,,1254
70.16,1922,1,,,70.16,675,1,,1247
70.18,1900,1,,,70.18,638,1,,1262
70.2,1858,1,,,70.2,676,1,,1182
70.22,1884,1,,,70.22,695,1,,1189
70.24,1899,1,,,70.24,657,1,,1242
70.26,1912,1,,,70.26,655,1,,1257
70.28,1890,1,,,70.28,637,1,,1253
70.3,1852,1,,,70.3,682,1,,1170
70.32,1882,1,,,70.32,686,1,,1196
70.34,1899,1,,,70.34,626,1,,1273
70.36,1977,1,,,70.36,656,1,,1321
70.38,1948,1,,,70.38,674,1,,1274
70.4,1902,1,,,70.4,634,1,,1268
70.42,1894,1,,,70.42,651,1,,1243
70.44,1918,1,,,70.44,669,1,,1249
70.46,1903,1,,,70.46,705,1,,1198
70.48,1834,1,,,70.48,645,1,,1189
70.5,1796,1,,,70.5,656,1,,1140
70.52,1889,1,,,70.52,663,1,,1226
70.54,1836,1,,,70.54,670,1,,1166
70.56,1824,1,,,70.56,658,1,,1166
70.58,1870,1,,,70.58,673,1,,1197
70.6,1874,1,,,70.6,665,1,,1209
70.62,1868,1,,,70.62,669,1,,1199
70.64,1869,1,,,70.64,659,1,,1210
70.66,1983,1,,,70.66,670,1,,1313
70.68,1930,1,,,70.68,691,1,,1239
70.7,1928,1,,,70.7,644,1,,1284
70.72,1855,1,,,70.72,658,1,,1197
70.74,1860,1,,,70.74,664,1,,1196
70.76,1912,1,,,70.76,630,1,,1282
70.78,1852,1,,,70.78,685,1,,1167
70.8,1883,1,,,70.8,630,1,,1253
70.82,1825,1,,,70.82,620,1,,1205
70.84,1844,1,,,70.84,683,1,,1161
70.86,1913,1,,,70.86,617,1,,1296
70.88,1862,1,,,70.88,650,1,,1212
70.9,1826,1,,,70.9,685,1,,1141
70.92,1877,1,,,70.92,646,1,,1231
70.94,1853,1,,,70.94,652,1,,1201
70.96,1874,1,,,70.96,698,1,,1176
70.98,1897,1,,,70.98,623,1,,1274
71,1870,1,,,71,647,1,,1223
71.02,1882,1,,,71.02,644,1,,1238
71.04,1927,1,,,71.04,610,1,,1317
71.06,1860,1,,,71.06,635,1,,1225
71.08,1869,1,,,71.08,654,1,,1215
71.1,1835,1,,,71.1,623,1,,1212
71.12,1863,1,,,71.12,650,1,,1213
71.14,1873,1,,,71.14,684,1,,1189
71.16,1822,1,,,71.16,673,1,,1149
71.18,1830,1,,,71.18,643,1,,1187
71.2,1887,1,,,71.2,621,1,,1266
71.22,1889,1,,,71.22,636,1,,1253
71.24,1874,1,,,71.24,621,1,,1253
71.26,1865,1,,,71.26,655,1,,1210
71.28,1854,1,,,71.28,631,1,,1223
71.3,1915,1,,,71.3,632,1,,1283
71.32,1884,1,,,71.32,666,1,,1218
71.34,1891,1,,,71.34,640,1,,1251
71.36,1815,1,,,71.36,664,1,,1151
71.38,1824,1,,,71.38,684,1,,1140
71.4,1868,1,,,71.4,665,1,,1203
71.42,1836,1,,,71.42,663,1,,1173
71.44,1899,1,,,71.44,641,1,,1258
71.46,1839,1,,,71.46,611,1,,1228
71.48,1868,1,,,71.48,672,1,,1196
71.5,1899,1,,,71.5,662,1,,1237
71.52,1760,1,,,71.52,625,1,,1135
71.54,1808,1,,,71.54,660,1,,1148
71.56,1837,1,,,71.56,666,1,,1171
71.58,1800,1,,,71.58,599,1,,1201
71.6,1884,1,,,71.6,625,1,,1259
71.62,1756,1,,,71.62,691,1,,1065
71.64,1811,1,,,71.64,638,1,,1173
71.66,1812,1,,,71.66,629,1,,1183
71.68,1864,1,,,71.68,662,1,,1202
71.7,1824,1,,,71.7,659,1,,1165
71.72,1873,1,,,71.72,659,1,,1214
71.74,1866,1,,,71.74,645,1,,1221
71.76,1850,1,,,71.76,637,1,,1213
71.78,1892,1,,,71.78,629,1,,1263
71.8,1875,1,,,71.8,631,1,,1244
71.82,1870,1,,,71.82,630,1,,1240
71.84,1797,1,,,71.84,652,1,,1145
71.86,1848,1,,,71.86,634,1,,1214
71.88,1805,1,,,71.88,616,1,,1189
71.9,1816,1,,,71.9,635,1,,1181
71.92,1840,1,,,71.92,626,1,,1214
71.94,1863,1,,,71.94,630,1,,1233
71.96,1823,1,,,71.96,606,1,,1217
71.98,1862,1,,,71.98,649,1,,1213
72,1870,1,,,72,644,1,,1226
72.02,1841,1,,,72.02,631,1,,1210
72.04,1893,1,,,72.04,631,1,,1262
72.06,1840,1,,,72.06,634,1,,1206
72.08,1889,1,,,72.08,616,1,,1273
72.1,1866,1,,,72.1,645,1,,1221
72.12,1798,1,,,72.12,626,1,,1172
72.14,1815,1,,,72.14,635,1,,1180
72.16,1825,1,,,72.16,620,1,,1205
72.18,1900,1,,,72.18,670,1,,1230
72.2,1817,1,,,72.2,635,1,,1182
72.22,1820,1,,,72.22,638,1,,1182
72.24,1845,1,,,72.24,629,1,,1216
72.26,1791,1,,,72.26,634,1,,1157
72.28,1867,1,,,72.28,657,1,,1210
72.3,1784,1,,,72.3,613,1,,1171
72.32,1860,1,,,72.32,616,1,,1244
72.34,1862,1,,,72.34,644,1,,1218
72.36,1850,1,,,72.36,611,1,,1239
72.38,1881,1,,,72.38,649,1,,1232
72.4,1873,1,,,72.4,597,1,,1276
72.42,1930,1,,,72.42,597,1,,1333
72.44,1804,1,,,72.44,639,1,,1165
72.46,1827,1,,,72.46,652,1,,1175
72.48,1746,1,,,72.48,630,1,,1116
72.5,1825,1,,,72.5,645,1,,1180
72.52,1859,1,,,72.52,617,1,,1242
72.54,1750,1,,,72.54,634,1,,1116
72.56,1817,1,,,72.56,613,1,,1204
72.58,1788,1,,,72.58,597,1,,1191
72.6,1772,1,,,72.6,602,1,,1170
72.62,1870,1,,,72.62,584,1,,1286
72.64,1795,1,,,72.64,631,1,,1164
72.66,1808,1,,,72.66,635,1,,1173
72.68,1776,1,,,72.68,599,1,,1177
72.7,1773,1,,,72.7,560,1,,1213
72.72,1792,1,,,72.72,617,1,,1175
72.74,1797,1,,,72.74,641,1,,1156
72.76,1796,1,,,72.76,609,1,,1187
72.78,1798,1,,,72.78,615,1,,1183
72.8,1795,1,,,72.8,643,1,,1152
72.82,1760,1,,,72.82,625,1,,1135
72.84,1766,1,,,72.84,603,1,,1163
72.86,1837,1,,,72.86,650,1,,1187
72.88,1745,1,,,72.88,583,1,,1162
72.9,1743,1,,,72.9,662,1,,1081
72.92,1729,1,,,72.92,661,1,,1068
72.94,1854,1,,,72.94,637,1,,1217
72.96,1809,1,,,72.96,666,1,,1143
72.98,1817,1,,,72.98,619,1,,1198
73,1687,1,,,73,655,1,,1032
73.02,1729,1,,,73.02,621,1,,1108
73.04,1783,1,,,73.04,646,1,,1137
73.06,1776,1,,,73.06,652,1,,1124
73.08,1797,1,,,73.08,621,1,,1176
73.1,1850,1,,,73.1,574,1,,1276
73.12,1730,1,,,73.12,609,1,,1121
73.14,1782,1,,,73.14,610,1,,1172
73.16,1759,1,,,73.16,603,1,,1156
73.18,1820,1,,,73.18,618,1,,1202
73.2,1763,1,,,73.2,642,1,,1121
73.22,1758,1,,,73.22,646,1,,1112
73.24,1792,1,,,73.24,618,1,,1174
73.26,1809,1,,,73.26,642,1,,1167
73.28,1763,1,,,73.28,596,1,,1167
73.3,1751,1,,,73.3,571,1,,1180
73.32,1801,1,,,73.32,579,1,,1222
73.34,1810,1,,,73.34,579,1,,1231
73.36,1813,1,,,73.36,601,1,,1212
73.38,1752,1,,,73.38,635,1,,1117
73.4,1824,1,,,73.4,611,1,,1213
73.42,1827,1,,,73.42,630,1,,1197
73.44,1779,1,,,73.44,608,1,,1171
73.46,1757,1,,,73.46,590,1,,1167
73.48,1726,1,,,73.48,578,1,,1148
73.5,1854,1,,,73.5,639,1,,1215
73.52,1757,1,,,73.52,570,1,,1187
73.54,1775,1,,,73.54,588,1,,1187
73.56,1699,1,,,73.56,625,1,,1074
73.58,1779,1,,,73.58,643,1,,1136
73.6,1774,1,,,73.6,611,1,,1163
73.62,1797,1,,,73.62,602,1,,1195
73.64,1849,1,,,73.64,612,1,,1237
73.66,1736,1,,,73.66,623,1,,1113
73.68,1768,1,,,73.68,625,1,,1143
73.7,1825,1,,,73.7,605,1,,1220
73.72,1799,1,,,73.72,610,1,,1189
73.74,1743,1,,,73.74,603,1,,1140
73.76,1700,1,,,73.76,545,1,,1155
73.78,1727,1,,,73.78,615,1,,1112
73.8,1733,1,,,73.8,581,1,,1152
73.82,1805,1,,,73.82,627,1,,1178
73.84,1809,1,,,73.84,614,1,,1195
73.86,1748,1,,,73.86,629,1,,1119
73.88,1721,1,,,73.88,637,1,,1084
73.9,1736,1,,,73.9,595,1,,1141
73.92,1792,1,,,73.92,601,1,,1191
73.94,1817,1,,,73.94,584,1,,1233
73.96,1795,1,,,73.96,594,1,,1201
73.98,1760,1,,,73.98,637,1,,1123
74,1804,1,,,74,598,1,,1206
74.02,1759,1,,,74.02,601,1,,1158
74.04,1713,1,,,74.04,616,1,,1097
74.06,1779,1,,,74.06,602,1,,1177
74.08,1784,1,,,74.08,608,1,,1176
74.1,1758,1,,,74.1,624,1,,1134
74.12,1712,1,,,74.12,624,1,,1088
74.14,1730,1,,,74.14,625,1,,1105
74.16,1751,1,,,74.16,609,1,,1142
74.18,1772,1,,,74.18,613,1,,1159
74.2,1772,1,,,74.2,587,1,,1185
74.22,1780,1,,,74.22,604,1,,1176
74.24,1721,1,,,74.24,621,1,,1100
74.26,1763,1,,,74.26,592,1,,1171
74.28,1785,1,,,74.28,580,1,,1205
74.3,1714,1,,,74.3,570,1,,1144
74.32,1783,1,,,74.32,590,1,,1193
74.34,1812,1,,,74.34,644,1,,1168
74.36,1786,1,,,74.36,635,1,,1151
74.38,1763,1,,,74.38,584,1,,1179
74.4,1737,1,,,74.4,595,1,,1142
74.42,1712,1,,,74.42,606,1,,1106
74.44,1808,1,,,74.44,582,1,,1226
74.46,1759,1,,,74.46,637,1,,1122
74.48,1710,1,,,74.48,621,1,,1089
74.5,1754,1,,,74.5,629,1,,1125
74.52,1731,1,,,74.52,616,1,,1115
74.54,1730,1,,,74.54,586,1,,1144
74.56,1669,1,,,74.56,598,1,,1071
74.58,1731,1,,,74.58,590,1,,1141
74.6,1735,1,,,74.6,591,1,,1144
74.62,1758,1,,,74.62,583,1,,1175
74.64,1721,1,,,74.64,619,1,,1102
74.66,1788,1,,,74.66,615,1,,1173
74.68,1694,1,,,74.68,591,1,,1103
74.7,1734,1,,,74.7,606,1,,1128
74.72,1746,1,,,74.72,597,1,,1149
74.74,1733,1,,,74.74,613,1,,1120
74.76,1740,1,,,74.76,579,1,,1161
74.78,1772,1,,,74.78,610,1,,1162
74.8,1814,1,,,74.8,625,1,,1189
74.82,1796,1,,,74.82,568,1,,1228
74.84,1731,1,,,74.84,626,1,,1105
74.86,1814,1,,,74.86,639,1,,1175
74.88,1709,1,,,74.88,597,1,,1112
74.9,1721,1,,,74.9,570,1,,1151
74.92,1678,1,,,74.92,545,1,,1133
74.94,1766,1,,,74.94,587,1,,1179
74.96,1812,1,,,74.96,569,1,,1243
74.98,1720,1,,,74.98,591,1,,1129
75,1801,1,,,75,539,1,,1262
75.02,1714,1,,,75.02,559,1,,1155
75.04,1769,1,,,75.04,583,1,,1186
75.06,1815,1,,,75.06,619,1,,1196
75.08,1783,1,,,75.08,576,1,,1207
75.1,1743,1,,,75.1,595,1,,1148
75.12,1750,1,,,75.12,595,1,,1155
75.14,1775,1,,,75.14,588,1,,1187
75.16,1701,1,,,75.16,607,1,,1094
75.18,1775,1,,,75.18,603,1,,1172
75.2,1773,1,,,75.2,588,1,,1185
75.22,1735,1,,,75.22,603,1,,1132
75.24,1781,1,,,75.24,599,1,,1182
75.26,1788,1,,,75.26,594,1,,1194
75.28,1790,1,,,75.28,581,1,,1209
75.3,1764,1,,,75.3,612,1,,1152
75.32,1771,1,,,75.32,574,1,,1197
75.34,1793,1,,,75.34,594,1,,1199
75.36,1764,1,,,75.36,565,1,,1199
75.38,1722,1,,,75.38,601,1,,1121
75.4,1670,1,,,75.4,581,1,,1089
75.42,1743,1,,,75.42,570,1,,1173
75.44,1742,1,,,75.44,603,1,,1139
75.46,1704,1,,,75.46,625,1,,1079
75.48,1738,1,,,75.48,579,1,,1159
75.5,1696,1,,,75.5,567,1,,1129
75.52,1732,1,,,75.52,538,1,,1194
75.54,1752,1,,,75.54,539,1,,1213
75.56,1800,1,,,75.56,596,1,,1204
75.58,1746,1,,,75.58,584,1,,1162
75.6,1747,1,,,75.6,594,1,,1153
75.62,1765,1,,,75.62,606,1,,1159
75.64,1764,1,,,75.64,596,1,,1168
75.66,1694,1,,,75.66,595,1,,1099
75.68,1753,1,,,75.68,586,1,,1167
75.7,1707,1,,,75.7,600,1,,1107
75.72,1734,1,,,75.72,604,1,,1130
75.74,1828,1,,,75.74,577,1,,1251
75.76,1776,1,,,75.76,599,1,,1177
75.78,1761,1,,,75.78,586,1,,1175
75.8,1848,1,,,75.8,571,1,,1277
75.82,1786,1,,,75.82,565,1,,1221
75.84,1769,1,,,75.84,553,1,,1216
75.86,1742,1,,,75.86,536,1,,1206
75.88,1792,1,,,75.88,604,1,,1188
75.9,1803,1,,,75.9,618,1,,1185
75.92,1780,1,,,75.92,592,1,,1188
75.94,1785,1,,,75.94,587,1,,1198
75.96,1755,1,,,75.96,573,1,,1182
75.98,1762,1,,,75.98,591,1,,1171
76,1744,1,,,76,594,1,,1150
76.02,1761,1,,,76.02,586,1,,1175
76.04,1734,1,,,76.04,567,1,,1167
76.06,1738,1,,,76.06,560,1,,1178
76.08,1796,1,,,76.08,574,1,,1222
76.1,1838,1,,,76.1,554,1,,1284
76.12,1835,1,,,76.12,591,1,,1244
76.14,1736,1,,,76.14,590,1,,1146
76.16,1741,1,,,76.16,581,1,,1160
76.18,1780,1,,,76.18,569,1,,1211
76.2,1867,1,,,76.2,542,1,,1325
76.22,1785,1,,,76.22,572,1,,1213
76.24,1801,1,,,76.24,564,1,,1237
76.26,1739,1,,,76.26,619,1,,1120
76.28,1805,1,,,76.28,597,1,,1208
76.3,1781,1,,,76.3,594,1,,1187
76.32,1806,1,,,76.32,543,1,,1263
76.34,1785,1,,,76.34,577,1,,1208
76.36,1821,1,,,76.36,570,1,,1251
76.38,1801,1,,,76.38,590,1,,1211
76.4,1772,1,,,76.4,588,1,,1184
76.42,1793,1,,,76.42,614,1,,1179
76.44,1771,1,,,76.44,577,1,,1194
76.46,1797,1,,,76.46,602,1,,1195
76.48,1820,1,,,76.48,598,1,,1222
76.5,1811,1,,,76.5,617,1,,1194
76.52,1804,1,,,76.52,600,1,,1204
76.54,1804,1,,,76.54,582,1,,1222
76.56,1815,1,,,76.56,581,1,,1234
76.58,1833,1,,,76.58,568,1,,1265
76.6,1849,1,,,76.6,590,1,,1259
76.62,1830,1,,,76.62,560,1,,1270
76.64,1816,1,,,76.64,580,1,,1236
76.66,1805,1,,,76.66,549,1,,1256
76.68,1894,1,,,76.68,590,1,,1304
76.7,1851,1,,,76.7,588,1,,1263
76.72,1861,1,,,76.72,575,1,,1286
76.74,1789,1,,,76.74,589,1,,1200
76.76,1868,1,,,76.76,574,1,,1294
76.78,1874,1,,,76.78,575,1,,1299
76.8,1864,1,,,76.8,579,1,,1285
76.82,1862,1,,,76.82,557,1,,1305
76.84,1872,1,,,76.84,548,1,,1324
76.86,1851,1,,,76.86,588,1,,1263
76.88,1883,1,,,76.88,576,1,,1307
76.9,1846,1,,,76.9,591,1,,1255
76.92,1847,1,,,76.92,577,1,,1270
76.94,1859,1,,,76.94,596,1,,1263
76.96,1946,1,,,76.96,551,1,,1395
76.98,1984,1,,,76.98,552,1,,1432
77,1915,1,,,77,553,1,,1362
77.02,1881,1,,,77.02,545,1,,1336
77.04,1964,1,,,77.04,573,1,,1391
77.06,2009,1,,,77.06,577,1,,1432
77.08,2000,1,,,77.08,586,1,,1414
77.1,2029,1,,,77.1,594,1,,1435
77.12,2024,1,,,77.12,622,1,,1402
77.14,1997,1,,,77.14,589,1,,1408
77.16,2105,1,,,77.16,561,1,,1544
77.18,2134,1,,,77.18,556,1,,1578
77.2,2057,1,,,77.2,516,1,,1541
77.22,2205,1,,,77.22,582,1,,1623
77.24,2222,1,,,77.24,571,1,,1651
77.26,2142,1,,,77.26,571,1,,1571
77.28,2128,1,,,77.28,577,1,,1551
77.3,2259,1,,,77.3,574,1,,1685
77.32,2288,1,,,77.32,588,1,,1700
77.34,2281,1,,,77.34,600,1,,1681
77.36,2259,1,,,77.36,579,1,,1680
77.38,2208,1,,,77.38,561,1,,1647
77.4,2252,1,,,77.4,581,1,,1671
77.42,2260,1,,,77.42,586,1,,1674
77.44,2209,1,,,77.44,564,1,,1645
77.46,2199,1,,,77.46,561,1,,1638
77.48,2217,1,,,77.48,594,1,,1623
77.5,2210,1,,,77.5,533,1,,1677
77.52,2185,1,,,77.52,560,1,,1625
77.54,2163,1,,,77.54,547,1,,1616
77.56,2220,1,,,77.56,556,1,,1664
77.58,2127,1,,,77.58,569,1,,1558
77.6,2141,1,,,77.6,561,1,,1580
77.62,2062,1,,,77.62,576,1,,1486
77.64,2082,1,,,77.64,565,1,,1517
77.66,2066,1,,,77.66,555,1,,1511
77.68,2056,1,,,77.68,560,1,,1496
77.7,2064,1,,,77.7,568,1,,1496
77.72,2012,1,,,77.72,559,1,,1453
77.74,1868,1,,,77.74,555,1,,1313
77.76,1901,1,,,77.76,587,1,,1314
77.78,1904,1,,,77.78,525,1,,1379
77.8,1879,1,,,77.8,572,1,,1307
77.82,1878,1,,,77.82,531,1,,1347
77.84,1878,1,,,77.84,593,1,,1285
77.86,1901,1,,,77.86,590,1,,1311
77.88,1844,1,,,77.88,562,1,,1282
77.9,1790,1,,,77.9,581,1,,1209
77.92,1825,1,,,77.92,578,1,,1247
77.94,1830,1,,,77.94,571,1,,1259
77.96,1836,1,,,77.96,584,1,,1252
77.98,1817,1,,,77.98,550,1,,1267
78,1789,1,,,78,569,1,,1220
78.02,1794,1,,,78.02,547,1,,1247
78.04,1783,1,,,78.04,555,1,,1228
78.06,1823,1,,,78.06,608,1,,1215
78.08,1812,1,,,78.08,556,1,,1256
78.1,1807,1,,,78.1,567,1,,1240
78.12,1735,1,,,78.12,604,1,,1131
78.14,1761,1,,,78.14,551,1,,1210
78.16,1814,1,,,78.16,541,1,,1273
78.18,1760,1,,,78.18,543,1,,1217
78.2,1733,1,,,78.2,553,1,,1180
78.22,1717,1,,,78.22,592,1,,1125
78.24,1749,1,,,78.24,589,1,,1160
78.26,1718,1,,,78.26,529,1,,1189
78.28,1694,1,,,78.28,544,1,,1150
78.3,1765,1,,,78.3,551,1,,1214
78.32,1709,1,,,78.32,575,1,,1134
78.34,1734,1,,,78.34,598,1,,1136
78.36,1702,1,,,78.36,560,1,,1142
78.38,1686,1,,,78.38,572,1,,1114
78.4,1699,1,,,78.4,585,1,,1114
78.42,1627,1,,,78.42,560,1,,1067
78.44,1738,1,,,78.44,542,1,,1196
78.46,1680,1,,,78.46,554,1,,1126
78.48,1672,1,,,78.48,553,1,,1119
78.5,1731,1,,,78.5,553,1,,1178
78.52,1705,1,,,78.52,557,1,,1148
78.54,1716,1,,,78.54,579,1,,1137
78.56,1778,1,,,78.56,555,1,,1223
78.58,1638,1,,,78.58,549,1,,1089
78.6,1694,1,,,78.6,540,1,,1154
78.62,1736,1,,,78.62,538,1,,1198
78.64,1733,1,,,78.64,510,1,,1223
78.66,1679,1,,,78.66,567,1,,1112
78.68,1724,1,,,78.68,576,1,,1148
78.7,1664,1,,,78.7,579,1,,1085
78.72,1700,1,,,78.72,521,1,,1179
78.74,1696,1,,,78.74,543,1,,1153
78.76,1745,1,,,78.76,548,1,,1197
78.78,1700,1,,,78.78,554,1,,1146
78.8,1725,1,,,78.8,547,1,,1178
78.82,1724,1,,,78.82,573,1,,1151
78.84,1674,1,,,78.84,593,1,,1081
78.86,1685,1,,,78.86,575,1,,1110
78.88,1780,1,,,78.88,556,1,,1224
78.9,1690,1,,,78.9,541,1,,1149
78.92,1677,1,,,78.92,527,1,,1150
78.94,1622,1,,,78.94,529,1,,1093
78.96,1628,1,,,78.96,518,1,,1110
78.98,1650,1,,,78.98,539,1,,1111
79,1684,1,,,79,534,1,,1150
79.02,1667,1,,,79.02,541,1,,1126
79.04,1609,1,,,79.04,537,1,,1072
79.06,1624,1,,,79.06,570,1,,1054
79.08,1630,1,,,79.08,571,1,,1059
79.1,1608,1,,,79.1,567,1,,1041
79.12,1712,1,,,79.12,535,1,,1177
79.14,1718,1,,,79.14,539,1,,1179
79.16,1683,1,,,79.16,548,1,,1135
79.18,1575,1,,,79.18,581,1,,994
79.2,1691,1,,,79.2,573,1,,1118
79.22,1640,1,,,79.22,535,1,,1105
79.24,1624,1,,,79.24,543,1,,1081
79.26,1634,1,,,79.26,566,1,,1068
79.28,1641,1,,,79.28,536,1,,1105
79.3,1680,1,,,79.3,559,1,,1121
79.32,1649,1,,,79.32,570,1,,1079
79.34,1691,1,,,79.34,575,1,,1116
79.36,1699,1,,,79.36,571,1,,1128
79.38,1610,1,,,79.38,571,1,,1039
79.4,1740,1,,,79.4,563,1,,1177
79.42,1679,1,,,79.42,536,1,,1143
79.44,1636,1,,,79.44,573,1,,1063
79.46,1653,1,,,79.46,545,1,,1108
79.48,1646,1,,,79.48,530,1,,1116
79.5,1603,1,,,79.5,541,1,,1062
79.52,1601,1,,,79.52,562,1,,1039
79.54,1582,1,,,79.54,578,1,,1004
79.56,1636,1,,,79.56,558,1,,1078
79.58,1626,1,,,79.58,547,1,,1079
79.6,1652,1,,,79.6,572,1,,1080
79.62,1668,1,,,79.62,567,1,,1101
79.64,1618,1,,,79.64,544,1,,1074
79.66,1640,1,,,79.66,560,1,,1080
79.68,1675,1,,,79.68,526,1,,1149
79.7,1581,1,,,79.7,549,1,,1032
79.72,1611,1,,,79.72,561,1,,1050
79.74,1645,1,,,79.74,530,1,,1115
79.76,1576,1,,,79.76,509,1,,1067
79.78,1698,1,,,79.78,544,1,,1154
79.8,1621,1,,,79.8,530,1,,1091
79.82,1620,1,,,79.82,519,1,,1101
79.84,1649,1,,,79.84,520,1,,1129
79.86,1671,1,,,79.86,521,1,,1150
79.88,1602,1,,,79.88,561,1,,1041
79.9,1594,1,,,79.9,573,1,,1021
79.92,1621,1,,,79.92,569,1,,1052
79.94,1592,1,,,79.94,565,1,,1027
79.96,1547,1,,,79.96,554,1,,993
79.98,1671,1,,,79.98,537,1,,1134
80,1641,1,,,80,531,1,,1110
79.940 1592.000 1.000,,,,,,,,,
79.960 1547.000 1.000,,,,,,,,,
79.980 1671.000 1.000,,,,,,,,,
80.000 1641.000 1.000,,,,,,,,,